,GAME_ID,TEAM_ID,TEAM_NAME,TEAM_ABBREVIATION,TEAM_CITY,MINUTES,PTS,CONTESTED_SHOTS,CONTESTED_SHOTS_2PT,CONTESTED_SHOTS_3PT,DEFLECTIONS,CHARGES_DRAWN,SCREEN_ASSISTS,SCREEN_AST_PTS,OFF_LOOSE_BALLS_RECOVERED,DEF_LOOSE_BALLS_RECOVERED,LOOSE_BALLS_RECOVERED,OFF_BOXOUTS,DEF_BOXOUTS,BOX_OUT_PLAYER_TEAM_REBS,BOX_OUT_PLAYER_REBS,BOX_OUTS
0,0022000001,1610612744,Warriors,GSW,Golden State,240.000000:00,99,69,44,25,14,2,7,16,4,2,6,0,13,9,2,13
1,0022000001,1610612751,Nets,BKN,Brooklyn,240.000000:00,125,57,39,18,17,1,11,24,3,4,7,2,7,6,5,9
0,0022000002,1610612746,Clippers,LAC,LA,240.000000:00,116,47,27,20,16,1,12,29,1,2,3,1,9,3,1,10
1,0022000002,1610612747,Lakers,LAL,Los Angeles,240.000000:00,109,54,34,20,11,0,9,21,2,0,2,2,10,11,4,12
0,0022000003,1610612749,Bucks,MIL,Milwaukee,240.000000:00,121,79,53,26,6,0,11,25,3,2,5,1,19,9,1,20
1,0022000003,1610612738,Celtics,BOS,Boston,240.000000:00,122,58,30,28,11,3,12,27,2,4,6,3,21,13,4,24
0,0022000004,1610612742,Mavericks,DAL,Dallas,240.000000:00,102,60,39,21,12,0,14,29,1,5,6,3,8,8,7,11
1,0022000004,1610612756,Suns,PHX,Phoenix,240.000000:00,106,63,34,29,11,0,11,24,2,3,5,1,4,3,1,5
0,0022000005,1610612740,Pelicans,NOP,New Orleans,240.000000:00,98,56,27,29,13,0,4,9,4,4,8,4,9,7,4,13
1,0022000005,1610612748,Heat,MIA,Miami,240.000000:00,111,54,28,26,22,1,10,26,4,4,8,3,26,19,6,29
0,0022000006,1610612744,Warriors,GSW,Golden State,240.000000:00,99,67,39,28,18,3,18,40,5,4,9,2,28,16,7,30
1,0022000006,1610612749,Bucks,MIL,Milwaukee,240.000000:00,138,73,43,30,16,1,7,17,4,3,7,4,25,20,9,29
0,0022000007,1610612751,Nets,BKN,Brooklyn,240.000000:00,123,50,38,12,13,1,8,19,1,3,4,1,6,6,2,7
1,0022000007,1610612738,Celtics,BOS,Boston,240.000000:00,95,39,23,16,12,1,8,17,6,3,9,1,10,7,1,11
0,0022000008,1610612742,Mavericks,DAL,Dallas,240.000000:00,115,58,27,31,21,0,11,27,1,1,2,1,8,5,3,9
1,0022000008,1610612747,Lakers,LAL,Los Angeles,240.000000:00,138,46,24,22,16,0,5,11,5,3,8,7,13,10,3,20
0,0022000009,1610612746,Clippers,LAC,LA,240.000000:00,121,51,25,26,13,1,5,11,7,3,10,1,11,6,2,12
1,0022000009,1610612743,Nuggets,DEN,Denver,240.000000:00,108,51,25,26,20,1,7,16,3,7,10,3,10,5,3,13
0,0022000010,1610612766,Hornets,CHA,Charlotte,240.000000:00,114,58,36,22,25,1,11,29,1,3,4,1,21,14,2,22
1,0022000010,1610612739,Cavaliers,CLE,Cleveland,240.000000:00,121,62,25,37,21,0,5,12,3,6,9,1,13,12,6,14
0,0022000011,1610612752,Knicks,NYK,New York,240.000000:00,107,68,46,22,11,0,10,22,1,3,4,0,6,5,3,6
1,0022000011,1610612754,Pacers,IND,Indiana,240.000000:00,121,54,36,18,16,2,8,18,2,4,6,1,5,6,0,6
0,0022000012,1610612748,Heat,MIA,Miami,240.000000:00,107,40,27,13,21,1,9,19,5,2,7,1,13,8,6,14
1,0022000012,1610612753,Magic,ORL,Orlando,240.000000:00,113,33,25,8,17,0,11,24,3,6,9,1,6,5,2,7
0,0022000013,1610612764,Wizards,WAS,Washington,240.000000:00,107,64,46,18,18,2,12,29,2,5,7,1,10,8,2,11
1,0022000013,1610612755,76ers,PHI,Philadelphia,240.000000:00,113,51,35,16,13,2,7,14,4,5,9,1,5,5,3,6
0,0022000014,1610612740,Pelicans,NOP,New Orleans,240.000000:00,113,58,29,29,18,1,7,17,3,5,8,3,3,6,4,6
1,0022000014,1610612761,Raptors,TOR,Toronto,240.000000:00,99,54,26,28,18,2,8,23,4,3,7,0,4,4,3,4
0,0022000015,1610612737,Hawks,ATL,Atlanta,240.000000:00,124,65,35,30,14,0,9,20,4,5,9,1,12,10,5,13
1,0022000015,1610612741,Bulls,CHI,Chicago,240.000000:00,104,55,28,27,12,0,10,22,7,6,13,2,15,9,3,17
0,0022000016,1610612760,Thunder,OKC,Oklahoma City,240.000000:00,114,48,27,21,17,0,11,26,1,0,1,6,2,8,7,8
1,0022000016,1610612745,Rockets,HOU,Houston,240.000000:00,112,51,31,20,17,1,8,17,3,1,4,0,9,9,4,9
0,0022000017,1610612759,Spurs,SAS,San Antonio,240.000000:00,131,62,48,14,12,0,12,27,2,2,4,1,7,6,2,8
1,0022000017,1610612763,Grizzlies,MEM,Memphis,240.000000:00,119,79,58,21,12,0,16,32,3,4,7,0,8,3,2,8
0,0022000018,1610612765,Pistons,DET,Detroit,240.000000:00,101,62,28,34,14,2,7,17,9,2,11,2,8,9,4,10
1,0022000018,1610612750,Timberwolves,MIN,Minnesota,240.000000:00,111,65,38,27,18,1,7,15,5,3,8,1,11,9,3,12
0,0022000019,1610612758,Kings,SAC,Sacramento,265.000000:00,124,57,40,17,16,1,3,7,6,1,7,0,8,7,3,8
1,0022000019,1610612743,Nuggets,DEN,Denver,265.000000:00,122,46,37,9,16,1,9,19,4,4,8,0,6,4,1,6
0,0022000020,1610612762,Jazz,UTA,Utah,240.000000:00,120,64,41,23,12,0,15,38,3,6,9,1,20,16,7,21
1,0022000020,1610612757,Trail Blazers,POR,Portland,240.000000:00,100,56,26,30,14,1,7,17,1,3,4,2,23,14,8,25
0,0022000021,1610612737,Hawks,ATL,Atlanta,240.000000:00,122,60,34,26,8,1,7,15,6,2,8,2,17,12,4,19
1,0022000021,1610612763,Grizzlies,MEM,Memphis,240.000000:00,112,54,32,22,12,0,11,24,3,0,3,2,6,6,3,8
0,0022000022,1610612760,Thunder,OKC,Oklahoma City,240.000000:00,109,62,41,21,19,0,3,6,3,4,7,0,7,5,2,7
1,0022000022,1610612766,Hornets,CHA,Charlotte,240.000000:00,107,56,34,22,20,1,7,15,2,5,7,2,5,5,2,7
0,0022000023,1610612739,Cavaliers,CLE,Cleveland,290.000000:00,128,68,38,30,21,1,5,13,1,3,4,3,10,11,6,13
1,0022000023,1610612765,Pistons,DET,Detroit,290.000000:00,119,49,40,9,13,0,5,12,6,5,11,2,2,4,4,4
0,0022000024,1610612753,Magic,ORL,Orlando,240.000000:00,130,44,22,22,15,1,13,27,5,2,7,3,7,8,6,10
1,0022000024,1610612764,Wizards,WAS,Washington,240.000000:00,120,57,37,20,13,3,9,19,4,3,7,0,17,12,1,17
0,0022000025,1610612755,76ers,PHI,Philadelphia,240.000000:00,109,51,31,20,17,0,6,12,2,5,7,4,14,12,8,18
1,0022000025,1610612752,Knicks,NYK,New York,240.000000:00,89,62,36,26,13,1,8,19,2,2,4,2,15,8,4,17
0,0022000026,1610612754,Pacers,IND,Indiana,240.000000:00,125,46,25,21,12,0,21,48,3,5,8,1,4,5,3,5
1,0022000026,1610612741,Bulls,CHI,Chicago,240.000000:00,106,46,36,10,14,1,6,16,2,2,4,1,7,4,3,8
0,0022000027,1610612761,Raptors,TOR,Toronto,240.000000:00,114,85,53,32,19,1,10,25,4,6,10,1,19,14,3,20
1,0022000027,1610612759,Spurs,SAS,San Antonio,240.000000:00,119,67,40,27,15,2,10,22,8,4,12,2,22,21,5,24
0,0022000028,1610612750,Timberwolves,MIN,Minnesota,240.000000:00,116,52,39,13,14,1,8,17,2,5,7,0,6,4,1,6
1,0022000028,1610612762,Jazz,UTA,Utah,240.000000:00,111,72,52,20,11,0,13,32,3,0,3,1,13,10,1,14
0,0022000029,1610612745,Rockets,HOU,Houston,265.000000:00,126,71,36,35,16,1,6,15,1,5,6,4,7,9,5,11
1,0022000029,1610612757,Trail Blazers,POR,Portland,265.000000:00,128,60,35,25,13,1,13,33,4,3,7,4,5,7,5,9
0,0022000030,1610612756,Suns,PHX,Phoenix,240.000000:00,103,55,41,14,11,0,6,13,4,3,7,1,6,7,3,7
1,0022000030,1610612758,Kings,SAC,Sacramento,240.000000:00,106,61,32,29,13,0,4,11,5,2,7,0,5,5,2,5
0,0022000031,1610612742,Mavericks,DAL,Dallas,240.000000:00,124,54,30,24,22,0,8,19,4,2,6,1,16,15,5,17
1,0022000031,1610612746,Clippers,LAC,LA,240.000000:00,73,50,23,27,9,0,7,16,2,2,4,1,9,8,5,10
0,0022000032,1610612751,Nets,BKN,Brooklyn,240.000000:00,104,62,41,21,21,2,4,10,1,2,3,0,9,8,1,9
1,0022000032,1610612766,Hornets,CHA,Charlotte,240.000000:00,106,61,24,37,15,1,5,10,4,2,6,1,21,17,2,22
0,0022000033,1610612753,Magic,ORL,Orlando,240.000000:00,120,58,37,21,14,1,19,42,2,3,5,0,10,8,3,10
1,0022000033,1610612764,Wizards,WAS,Washington,240.000000:00,113,66,51,15,11,1,7,15,2,6,8,2,11,9,5,13
0,0022000034,1610612759,Spurs,SAS,San Antonio,240.000000:00,95,55,42,13,15,0,3,6,2,3,5,0,12,11,5,12
1,0022000034,1610612740,Pelicans,NOP,New Orleans,240.000000:00,98,68,39,29,17,2,12,26,1,7,8,3,3,6,2,6
0,0022000035,1610612755,76ers,PHI,Philadelphia,240.000000:00,94,45,37,8,15,0,4,9,3,2,5,1,7,6,2,8
1,0022000035,1610612739,Cavaliers,CLE,Cleveland,240.000000:00,118,45,27,18,18,1,20,43,5,7,12,2,8,6,4,10
0,0022000036,1610612749,Bucks,MIL,Milwaukee,240.000000:00,110,62,41,21,19,1,7,14,4,2,6,2,6,5,1,8
1,0022000036,1610612752,Knicks,NYK,New York,240.000000:00,130,48,23,25,10,1,14,31,5,2,7,0,8,6,0,8
0,0022000037,1610612738,Celtics,BOS,Boston,240.000000:00,107,61,39,22,23,1,6,15,4,3,7,0,20,9,4,20
1,0022000037,1610612754,Pacers,IND,Indiana,240.000000:00,108,52,34,18,15,0,15,33,1,5,6,0,14,8,5,14
0,0022000038,1610612744,Warriors,GSW,Golden State,240.000000:00,129,48,23,25,22,1,12,29,0,7,7,0,4,1,0,4
1,0022000038,1610612741,Bulls,CHI,Chicago,240.000000:00,128,48,27,21,9,0,8,18,1,2,3,0,6,3,1,6
0,0022000039,1610612756,Suns,PHX,Phoenix,240.000000:00,116,50,34,16,14,2,9,19,1,2,3,2,10,6,4,12
1,0022000039,1610612758,Kings,SAC,Sacramento,240.000000:00,100,61,33,28,7,0,6,14,2,3,5,2,5,4,1,7
0,0022000040,1610612750,Timberwolves,MIN,Minnesota,240.000000:00,91,46,24,22,21,0,7,15,5,1,6,1,0,1,1,1
1,0022000040,1610612747,Lakers,LAL,Los Angeles,240.000000:00,127,64,42,22,11,2,12,26,2,3,5,0,5,4,2,5
0,0022000041,1610612765,Pistons,DET,Detroit,240.000000:00,120,45,24,21,8,0,14,33,1,3,4,2,10,7,4,12
1,0022000041,1610612737,Hawks,ATL,Atlanta,240.000000:00,128,52,29,23,10,1,7,15,3,6,9,1,13,3,1,14
0,0022000042,1610612763,Grizzlies,MEM,Memphis,265.000000:00,116,48,33,15,20,0,7,15,0,3,3,0,7,5,4,7
1,0022000042,1610612751,Nets,BKN,Brooklyn,265.000000:00,111,59,46,13,21,2,12,32,4,3,7,4,12,13,10,16
0,0022000043,1610612762,Jazz,UTA,Utah,240.000000:00,110,57,32,25,12,1,23,54,3,5,8,0,9,8,3,9
1,0022000043,1610612760,Thunder,OKC,Oklahoma City,240.000000:00,109,54,30,24,13,1,9,19,1,2,3,1,13,11,4,14
0,0022000044,1610612745,Rockets,HOU,Houston,240.000000:00,111,54,32,22,12,2,6,15,3,3,6,2,9,5,2,11
1,0022000044,1610612743,Nuggets,DEN,Denver,240.000000:00,124,69,36,33,17,0,7,17,0,3,3,3,6,4,3,9
0,0022000045,1610612757,Trail Blazers,POR,Portland,240.000000:00,115,40,31,9,19,0,12,33,4,4,8,5,7,8,4,12
1,0022000045,1610612747,Lakers,LAL,Los Angeles,240.000000:00,107,47,24,23,12,1,7,17,2,3,5,1,9,4,1,10
0,0022000046,1610612752,Knicks,NYK,New York,240.000000:00,95,60,40,20,15,0,4,10,3,6,9,0,13,7,3,13
1,0022000046,1610612739,Cavaliers,CLE,Cleveland,240.000000:00,86,58,41,17,28,1,6,13,7,7,14,1,2,1,0,3
0,0022000047,1610612744,Warriors,GSW,Golden State,240.000000:00,116,77,49,28,17,1,15,36,4,3,7,0,22,13,2,22
1,0022000047,1610612765,Pistons,DET,Detroit,240.000000:00,106,50,29,21,11,0,12,25,8,7,15,2,17,13,6,19
0,0022000048,1610612738,Celtics,BOS,Boston,240.000000:00,116,48,27,21,25,0,7,14,1,2,3,1,11,6,1,12
1,0022000048,1610612754,Pacers,IND,Indiana,240.000000:00,111,40,27,13,22,1,8,17,4,5,9,0,9,7,2,9
0,0022000049,1610612761,Raptors,TOR,Toronto,240.000000:00,93,72,46,26,22,0,7,19,4,3,7,1,8,8,3,9
1,0022000049,1610612755,76ers,PHI,Philadelphia,240.000000:00,100,61,31,30,11,0,8,18,3,3,6,1,11,6,3,12
0,0022000050,1610612741,Bulls,CHI,Chicago,240.000000:00,115,61,34,27,15,1,10,23,3,1,4,0,7,6,2,7
1,0022000050,1610612764,Wizards,WAS,Washington,240.000000:00,107,60,32,28,11,1,11,23,4,2,6,3,7,8,4,10
0,0022000051,1610612749,Bucks,MIL,Milwaukee,240.000000:00,144,52,27,25,18,0,15,37,4,4,8,1,4,3,1,5
1,0022000051,1610612748,Heat,MIA,Miami,240.000000:00,97,58,28,30,17,2,17,42,4,3,7,0,22,11,4,22
0,0022000052,1610612753,Magic,ORL,Orlando,240.000000:00,118,61,34,27,22,0,10,23,1,2,3,0,4,3,1,4
1,0022000052,1610612760,Thunder,OKC,Oklahoma City,240.000000:00,107,66,51,15,4,1,12,27,6,3,9,0,10,7,2,10
0,0022000053,1610612740,Pelicans,NOP,New Orleans,240.000000:00,86,58,22,36,23,0,8,18,4,4,8,3,11,11,7,14
1,0022000053,1610612756,Suns,PHX,Phoenix,240.000000:00,111,57,37,20,11,0,4,10,5,5,10,0,13,7,5,13
0,0022000054,1610612750,Timberwolves,MIN,Minnesota,240.000000:00,101,44,22,22,15,0,11,25,3,3,6,1,12,10,7,13
1,0022000054,1610612746,Clippers,LAC,LA,240.000000:00,124,58,32,26,13,0,14,32,4,4,8,0,12,5,3,12
0,0022000055,1610612743,Nuggets,DEN,Denver,240.000000:00,115,57,38,19,10,0,5,12,1,2,3,1,5,5,2,6
1,0022000055,1610612758,Kings,SAC,Sacramento,240.000000:00,125,49,30,19,12,1,4,10,2,5,7,3,4,5,4,7
0,0022000056,1610612763,Grizzlies,MEM,Memphis,240.000000:00,107,43,23,20,18,0,12,26,3,4,7,3,9,10,5,12
1,0022000056,1610612738,Celtics,BOS,Boston,240.000000:00,126,48,31,17,20,0,9,23,3,6,9,0,10,8,1,10
0,0022000057,1610612737,Hawks,ATL,Atlanta,240.000000:00,141,66,39,27,12,0,10,23,0,5,5,4,16,14,5,20
1,0022000057,1610612751,Nets,BKN,Brooklyn,240.000000:00,145,57,29,28,16,0,17,42,2,0,2,0,11,7,2,11
0,0022000058,1610612749,Bucks,MIL,Milwaukee,240.000000:00,108,55,25,30,21,0,1,2,7,7,14,0,12,6,2,12
1,0022000058,1610612748,Heat,MIA,Miami,240.000000:00,119,66,40,26,13,2,11,28,4,4,8,1,19,9,2,20
0,0022000059,1610612766,Hornets,CHA,Charlotte,240.000000:00,118,45,24,21,12,1,6,13,1,7,8,3,9,10,7,12
1,0022000059,1610612742,Mavericks,DAL,Dallas,240.000000:00,99,45,28,17,18,0,8,19,4,3,7,0,9,7,2,9
0,0022000060,1610612747,Lakers,LAL,Los Angeles,240.000000:00,121,59,44,15,7,3,7,17,4,3,7,3,9,9,3,12
1,0022000060,1610612759,Spurs,SAS,San Antonio,240.000000:00,107,55,39,16,15,0,7,15,1,6,7,0,3,1,1,3
0,0022000061,1610612757,Trail Blazers,POR,Portland,240.000000:00,105,39,19,20,7,0,9,22,3,1,4,1,10,6,2,11
1,0022000061,1610612746,Clippers,LAC,LA,240.000000:00,128,44,24,20,17,0,14,33,4,4,8,1,14,7,2,15
0,0022000062,1610612739,Cavaliers,CLE,Cleveland,240.000000:00,99,47,30,17,21,0,1,2,1,1,2,0,10,9,6,10
1,0022000062,1610612754,Pacers,IND,Indiana,240.000000:00,119,41,29,12,22,1,16,41,4,3,7,1,11,11,4,12
0,0022000063,1610612741,Bulls,CHI,Chicago,240.000000:00,133,57,37,20,15,0,10,23,3,4,7,0,15,10,2,15
1,0022000063,1610612764,Wizards,WAS,Washington,240.000000:00,130,64,38,26,17,1,15,32,3,3,6,1,8,6,3,9
0,0022000064,1610612755,76ers,PHI,Philadelphia,240.000000:00,116,57,41,16,15,0,11,27,1,3,4,2,10,11,6,12
1,0022000064,1610612753,Magic,ORL,Orlando,240.000000:00,92,51,36,15,12,1,6,14,3,3,6,2,4,6,2,6
0,0022000065,1610612758,Kings,SAC,Sacramento,240.000000:00,119,56,26,30,20,0,8,18,4,2,6,3,11,8,3,14
1,0022000065,1610612745,Rockets,HOU,Houston,240.000000:00,122,49,28,21,18,2,9,22,1,6,7,4,14,13,9,18
0,0022000066,1610612752,Knicks,NYK,New York,240.000000:00,83,55,19,36,10,0,2,4,3,4,7,2,7,7,6,9
1,0022000066,1610612761,Raptors,TOR,Toronto,240.000000:00,100,60,35,25,12,1,10,25,1,3,4,1,4,5,2,5
0,0022000067,1610612740,Pelicans,NOP,New Orleans,240.000000:00,113,66,24,42,15,1,17,37,3,1,4,1,7,5,1,8
1,0022000067,1610612760,Thunder,OKC,Oklahoma City,240.000000:00,80,74,46,28,15,0,4,10,1,1,2,1,6,7,4,7
0,0022000068,1610612756,Suns,PHX,Phoenix,240.000000:00,106,42,25,17,16,0,13,26,4,2,6,1,12,13,2,13
1,0022000068,1610612762,Jazz,UTA,Utah,240.000000:00,95,42,28,14,14,0,9,23,7,2,9,2,12,12,7,14
0,0022000069,1610612763,Grizzlies,MEM,Memphis,240.000000:00,108,66,43,23,22,0,1,2,2,1,3,3,9,9,3,12
1,0022000069,1610612766,Hornets,CHA,Charlotte,240.000000:00,93,67,33,34,16,1,9,19,2,3,5,0,13,9,2,13
0,0022000070,1610612738,Celtics,BOS,Boston,240.000000:00,93,70,47,23,19,2,12,28,1,5,6,2,16,10,5,18
1,0022000070,1610612765,Pistons,DET,Detroit,240.000000:00,96,39,23,16,11,0,11,27,4,0,4,5,8,9,8,13
0,0022000071,1610612748,Heat,MIA,Miami,240.000000:00,83,44,19,25,17,0,6,12,5,5,10,2,12,9,5,14
1,0022000071,1610612742,Mavericks,DAL,Dallas,240.000000:00,93,37,18,19,11,0,8,20,6,2,8,1,11,12,5,12
0,0022000072,1610612737,Hawks,ATL,Atlanta,240.000000:00,114,48,25,23,17,0,14,33,5,4,9,1,14,9,3,15
1,0022000072,1610612751,Nets,BKN,Brooklyn,240.000000:00,96,51,31,20,22,0,6,13,2,2,4,3,8,10,4,11
0,0022000073,1610612741,Bulls,CHI,Chicago,240.000000:00,96,54,24,30,14,1,14,28,3,2,5,5,18,17,5,23
1,0022000073,1610612749,Bucks,MIL,Milwaukee,240.000000:00,126,53,38,15,21,1,4,10,1,4,5,4,11,12,7,15
0,0022000074,1610612764,Wizards,WAS,Washington,240.000000:00,130,58,34,24,15,1,17,40,3,2,5,3,17,19,9,20
1,0022000074,1610612750,Timberwolves,MIN,Minnesota,240.000000:00,109,52,34,18,17,0,10,25,1,5,6,1,11,7,5,12
0,0022000075,1610612747,Lakers,LAL,Los Angeles,240.000000:00,109,58,34,24,15,2,9,21,1,7,8,5,11,12,7,16
1,0022000075,1610612759,Spurs,SAS,San Antonio,240.000000:00,103,84,57,27,10,0,9,19,5,3,8,1,10,8,2,11
0,0022000076,1610612756,Suns,PHX,Phoenix,240.000000:00,106,48,31,17,7,1,9,20,5,1,6,1,2,2,2,3
1,0022000076,1610612743,Nuggets,DEN,Denver,240.000000:00,103,43,22,21,17,1,11,26,1,2,3,4,6,8,6,10
0,0022000077,1610612746,Clippers,LAC,LA,240.000000:00,100,57,31,26,17,3,8,18,7,4,11,1,4,3,2,5
1,0022000077,1610612762,Jazz,UTA,Utah,240.000000:00,106,55,29,26,11,0,11,25,2,0,2,1,3,3,3,4
0,0022000078,1610612757,Trail Blazers,POR,Portland,240.000000:00,123,45,23,22,14,2,11,29,2,5,7,3,3,6,3,6
1,0022000078,1610612744,Warriors,GSW,Golden State,240.000000:00,98,66,38,28,14,0,5,11,1,2,3,1,7,4,1,8
0,0022000079,1610612758,Kings,SAC,Sacramento,240.000000:00,94,44,25,19,8,0,4,9,5,1,6,4,5,8,6,9
1,0022000079,1610612745,Rockets,HOU,Houston,240.000000:00,102,52,39,13,12,1,6,15,2,3,5,1,16,12,6,17
0,0022000080,1610612752,Knicks,NYK,New York,240.000000:00,106,52,23,29,13,1,8,16,2,3,5,4,9,12,5,13
1,0022000080,1610612754,Pacers,IND,Indiana,240.000000:00,102,56,37,19,13,1,10,27,4,5,9,1,3,4,3,4
0,0022000081,1610612760,Thunder,OKC,Oklahoma City,240.000000:00,108,86,61,25,10,0,7,17,4,1,5,1,14,9,1,15
1,0022000081,1610612753,Magic,ORL,Orlando,240.000000:00,99,57,34,23,11,0,14,31,5,3,8,1,6,6,2,7
0,0022000082,1610612766,Hornets,CHA,Charlotte,240.000000:00,112,51,29,22,23,0,12,28,3,3,6,0,3,3,2,3
1,0022000082,1610612755,76ers,PHI,Philadelphia,240.000000:00,127,65,40,25,14,0,3,6,4,5,9,1,3,4,1,4
0,0022000083,1610612739,Cavaliers,CLE,Cleveland,240.000000:00,96,45,28,17,13,1,13,27,1,2,3,4,2,6,6,6
1,0022000083,1610612737,Hawks,ATL,Atlanta,240.000000:00,91,49,30,19,15,0,9,20,4,4,8,3,2,4,3,5
0,0022000084,1610612761,Raptors,TOR,Toronto,240.000000:00,116,60,31,29,13,3,4,11,7,6,13,0,11,9,3,11
1,0022000084,1610612740,Pelicans,NOP,New Orleans,240.000000:00,120,52,28,24,11,0,6,15,5,5,10,0,21,15,3,21
0,0022000085,1610612738,Celtics,BOS,Boston,240.000000:00,122,55,33,22,22,1,8,21,4,4,8,2,12,12,4,14
1,0022000085,1610612765,Pistons,DET,Detroit,240.000000:00,120,51,31,20,11,1,10,24,2,5,7,2,8,9,4,10
0,0022000086,1610612764,Wizards,WAS,Washington,240.000000:00,123,45,25,20,13,0,5,12,5,5,10,2,16,13,7,18
1,0022000086,1610612751,Nets,BKN,Brooklyn,240.000000:00,122,57,44,13,12,0,11,24,2,4,6,1,6,4,4,7
0,0022000087,1610612747,Lakers,LAL,Los Angeles,240.000000:00,108,67,44,23,18,0,8,19,3,5,8,2,12,12,3,14
1,0022000087,1610612763,Grizzlies,MEM,Memphis,240.000000:00,94,60,33,27,14,0,6,12,5,0,5,4,9,9,6,13
0,0022000088,1610612743,Nuggets,DEN,Denver,240.000000:00,124,46,25,21,12,0,12,26,6,1,7,1,8,8,2,9
1,0022000088,1610612750,Timberwolves,MIN,Minnesota,240.000000:00,109,46,24,22,18,0,10,23,3,3,6,2,8,8,2,10
0,0022000089,1610612762,Jazz,UTA,Utah,240.000000:00,130,64,52,12,7,0,14,33,5,3,8,1,14,11,6,15
1,0022000089,1610612759,Spurs,SAS,San Antonio,240.000000:00,109,37,22,15,22,1,17,34,2,2,4,0,10,6,1,10
0,0022000090,1610612742,Mavericks,DAL,Dallas,240.000000:00,108,61,31,30,20,2,13,30,1,2,3,1,10,6,3,11
1,0022000090,1610612741,Bulls,CHI,Chicago,240.000000:00,118,62,27,35,19,1,14,32,4,2,6,0,13,11,0,13
0,0022000091,1610612746,Clippers,LAC,LA,240.000000:00,112,47,25,22,9,0,9,22,5,5,10,2,12,13,6,14
1,0022000091,1610612756,Suns,PHX,Phoenix,240.000000:00,107,52,29,23,11,1,8,17,3,5,8,3,13,10,5,16
0,0022000092,1610612757,Trail Blazers,POR,Portland,240.000000:00,122,50,27,23,17,0,13,28,5,1,6,2,5,6,4,7
1,0022000092,1610612744,Warriors,GSW,Golden State,240.000000:00,137,72,36,36,17,2,14,32,3,4,7,0,8,6,1,8
0,0022000093,1610612739,Cavaliers,CLE,Cleveland,240.000000:00,83,62,38,24,16,2,6,15,5,2,7,2,7,8,3,9
1,0022000093,1610612753,Magic,ORL,Orlando,240.000000:00,103,38,24,14,26,3,7,18,3,2,5,3,3,5,2,6
0,0022000094,1610612766,Hornets,CHA,Charlotte,240.000000:00,101,53,33,20,11,0,8,19,6,3,9,0,9,6,2,9
1,0022000094,1610612755,76ers,PHI,Philadelphia,240.000000:00,118,51,23,28,11,0,2,4,2,6,8,4,8,7,6,12
0,0022000095,1610612752,Knicks,NYK,New York,240.000000:00,113,56,32,24,9,0,10,22,6,3,9,1,23,16,9,24
1,0022000095,1610612737,Hawks,ATL,Atlanta,240.000000:00,108,46,35,11,9,1,10,21,4,3,7,2,9,6,3,11
0,0022000096,1610612760,Thunder,OKC,Oklahoma City,240.000000:00,90,54,24,30,15,0,2,5,3,6,9,2,9,7,2,11
1,0022000096,1610612748,Heat,MIA,Miami,240.000000:00,118,60,21,39,19,1,13,32,5,8,13,1,16,7,4,17
0,0022000097,1610612738,Celtics,BOS,Boston,240.000000:00,126,55,36,19,10,2,13,30,3,1,4,2,8,6,4,10
1,0022000097,1610612761,Raptors,TOR,Toronto,240.000000:00,114,48,31,17,19,1,11,26,5,3,8,1,6,5,1,7
0,0022000098,1610612742,Mavericks,DAL,Dallas,240.000000:00,113,54,22,32,17,0,10,26,3,1,4,2,14,9,3,16
1,0022000098,1610612745,Rockets,HOU,Houston,240.000000:00,100,51,20,31,17,3,2,4,3,1,4,1,9,4,2,10
0,0022000099,1610612765,Pistons,DET,Detroit,240.000000:00,115,57,31,26,19,3,13,31,5,6,11,2,8,8,1,10
1,0022000099,1610612749,Bucks,MIL,Milwaukee,240.000000:00,125,61,35,26,13,0,5,12,6,4,10,3,8,9,5,11
0,0022000100,1610612754,Pacers,IND,Indiana,265.000000:00,118,71,47,24,21,1,10,25,1,5,6,0,11,8,2,11
1,0022000100,1610612740,Pelicans,NOP,New Orleans,265.000000:00,116,59,30,29,9,4,7,15,8,4,12,2,10,8,5,12
0,0022000101,1610612758,Kings,SAC,Sacramento,240.000000:00,106,49,25,24,14,0,7,17,4,2,6,3,8,7,2,11
1,0022000101,1610612744,Warriors,GSW,Golden State,240.000000:00,137,56,32,24,12,2,6,16,3,3,6,2,17,14,5,19
0,0022000102,1610612762,Jazz,UTA,Utah,240.000000:00,96,47,27,20,17,0,11,25,0,2,2,1,7,8,5,8
1,0022000102,1610612751,Nets,BKN,Brooklyn,240.000000:00,130,40,28,12,14,0,15,36,0,2,2,2,13,15,11,15
0,0022000103,1610612747,Lakers,LAL,Los Angeles,240.000000:00,94,45,34,11,17,2,8,17,0,3,3,4,4,5,4,8
1,0022000103,1610612763,Grizzlies,MEM,Memphis,240.000000:00,92,57,38,19,18,0,2,4,1,5,6,0,5,4,1,5
0,0022000104,1610612750,Timberwolves,MIN,Minnesota,240.000000:00,116,52,36,16,13,0,9,22,3,4,7,0,9,5,4,9
1,0022000104,1610612743,Nuggets,DEN,Denver,240.000000:00,123,65,36,29,12,0,5,11,0,3,3,3,7,8,6,10
0,0022000105,1610612759,Spurs,SAS,San Antonio,240.000000:00,116,47,25,22,22,0,15,39,2,3,5,1,2,3,2,3
1,0022000105,1610612746,Clippers,LAC,LA,240.000000:00,113,69,39,30,13,2,9,21,4,2,6,0,7,5,4,7
0,0022000106,1610612741,Bulls,CHI,Chicago,240.000000:00,111,66,31,35,15,1,12,29,4,3,7,1,5,4,1,6
1,0022000106,1610612757,Trail Blazers,POR,Portland,240.000000:00,108,49,28,21,18,1,14,37,3,2,5,1,5,6,4,6
0,0022000107,1610612745,Rockets,HOU,Houston,240.000000:00,107,63,50,13,17,0,9,18,2,2,4,3,17,12,4,20
1,0022000107,1610612754,Pacers,IND,Indiana,240.000000:00,114,65,45,20,21,0,11,27,4,5,9,0,11,9,4,11
0,0022000108,1610612739,Cavaliers,CLE,Cleveland,240.000000:00,94,59,41,18,18,1,8,17,5,0,5,4,10,9,6,14
1,0022000108,1610612753,Magic,ORL,Orlando,240.000000:00,105,45,28,17,9,1,21,49,4,4,8,1,22,11,4,23
0,0022000109,1610612764,Wizards,WAS,Washington,240.000000:00,136,50,31,19,16,0,12,32,3,4,7,3,8,10,6,11
1,0022000109,1610612755,76ers,PHI,Philadelphia,240.000000:00,141,42,25,17,11,0,11,24,2,5,7,1,4,3,2,5
0,0022000110,1610612766,Hornets,CHA,Charlotte,240.000000:00,102,57,34,23,13,0,6,14,3,7,10,3,16,14,10,19
1,0022000110,1610612737,Hawks,ATL,Atlanta,240.000000:00,94,54,31,23,13,0,1,2,7,4,11,2,11,11,7,13
0,0022000111,1610612738,Celtics,BOS,Boston,240.000000:00,107,54,35,19,11,0,8,20,3,5,8,2,7,9,5,9
1,0022000111,1610612748,Heat,MIA,Miami,240.000000:00,105,76,47,29,14,1,7,17,3,1,4,1,9,8,4,10
0,0022000112,1610612762,Jazz,UTA,Utah,240.000000:00,100,41,34,7,11,0,9,21,2,4,6,2,7,7,2,9
1,0022000112,1610612752,Knicks,NYK,New York,240.000000:00,112,40,23,17,11,0,13,29,3,5,8,1,21,20,9,22
0,0022000113,1610612765,Pistons,DET,Detroit,240.000000:00,115,61,28,33,15,2,8,19,1,6,7,4,14,10,7,18
1,0022000113,1610612749,Bucks,MIL,Milwaukee,240.000000:00,130,66,33,33,13,0,7,16,3,1,4,1,16,11,6,17
0,0022000114,1610612760,Thunder,OKC,Oklahoma City,240.000000:00,111,65,51,14,12,3,5,13,1,5,6,1,4,2,0,5
1,0022000114,1610612740,Pelicans,NOP,New Orleans,240.000000:00,110,58,23,35,13,0,16,35,4,3,7,2,5,6,3,7
0,0022000115,1610612761,Raptors,TOR,Toronto,240.000000:00,115,59,33,26,11,0,7,18,6,4,10,0,12,6,3,12
1,0022000115,1610612756,Suns,PHX,Phoenix,240.000000:00,123,58,32,26,10,0,6,14,3,3,6,2,16,11,8,18
0,0022000116,1610612746,Clippers,LAC,LA,240.000000:00,108,46,27,19,16,0,9,18,4,3,7,1,10,9,7,11
1,0022000116,1610612744,Warriors,GSW,Golden State,240.000000:00,101,54,25,29,22,0,9,21,6,4,10,0,13,10,1,13
0,0022000117,1610612741,Bulls,CHI,Chicago,240.000000:00,124,42,26,16,14,0,16,34,2,1,3,1,2,3,3,3
1,0022000117,1610612758,Kings,SAC,Sacramento,240.000000:00,128,58,35,23,16,0,12,28,2,2,4,1,7,6,3,8
0,0022000118,1610612755,76ers,PHI,Philadelphia,240.000000:00,109,72,46,26,15,0,16,34,3,0,3,1,13,11,4,14
1,0022000118,1610612751,Nets,BKN,Brooklyn,240.000000:00,122,64,47,17,14,0,13,29,6,4,10,2,13,11,6,15
0,0022000119,1610612739,Cavaliers,CLE,Cleveland,240.000000:00,94,33,22,11,21,2,3,7,4,4,8,6,2,3,2,8
1,0022000119,1610612763,Grizzlies,MEM,Memphis,240.000000:00,90,38,27,11,20,0,7,15,4,4,8,3,4,5,3,7
0,0022000120,1610612742,Mavericks,DAL,Dallas,265.000000:00,124,58,41,17,15,1,9,21,2,6,8,1,4,4,2,5
1,0022000120,1610612743,Nuggets,DEN,Denver,265.000000:00,117,41,19,22,15,0,11,25,4,3,7,4,6,9,7,10
0,0022000121,1610612759,Spurs,SAS,San Antonio,240.000000:00,118,46,30,16,11,3,8,17,3,3,6,2,11,8,5,13
1,0022000121,1610612747,Lakers,LAL,Los Angeles,240.000000:00,109,62,37,25,10,0,7,15,0,3,3,3,2,5,2,5
0,0022000122,1610612750,Timberwolves,MIN,Minnesota,240.000000:00,117,43,22,21,20,1,8,18,6,4,10,1,9,8,4,10
1,0022000122,1610612757,Trail Blazers,POR,Portland,240.000000:00,135,45,22,23,21,0,14,32,3,5,8,5,6,8,5,11
0,0022000123,1610612756,Suns,PHX,Phoenix,265.000000:00,105,66,37,29,16,0,8,18,3,6,9,3,19,17,7,22
1,0022000123,1610612765,Pistons,DET,Detroit,265.000000:00,110,60,19,41,19,0,9,20,3,4,7,2,18,18,9,20
0,0022000124,1610612764,Wizards,WAS,Washington,240.000000:00,107,63,40,23,19,0,9,21,4,4,8,2,7,4,1,9
1,0022000124,1610612738,Celtics,BOS,Boston,240.000000:00,116,46,36,10,18,1,9,19,4,5,9,0,10,8,6,10
0,0022000125,1610612760,Thunder,OKC,Oklahoma City,240.000000:00,101,62,45,17,9,0,5,13,5,2,7,1,11,12,5,12
1,0022000125,1610612752,Knicks,NYK,New York,240.000000:00,89,58,35,23,15,0,7,14,2,6,8,1,3,2,1,4
0,0022000126,1610612766,Hornets,CHA,Charlotte,240.000000:00,118,48,22,26,14,0,2,5,2,1,3,2,7,8,1,9
1,0022000126,1610612740,Pelicans,NOP,New Orleans,240.000000:00,110,63,31,32,13,2,3,9,3,0,3,1,6,3,2,7
0,0022000127,1610612753,Magic,ORL,Orlando,240.000000:00,90,43,19,24,11,1,12,24,5,1,6,2,3,4,1,5
1,0022000127,1610612745,Rockets,HOU,Houston,240.000000:00,132,48,29,19,18,0,2,5,5,4,9,2,6,6,4,8
0,0022000128,1610612751,Nets,BKN,Brooklyn,240.000000:00,110,59,41,18,10,0,17,39,2,3,5,0,17,10,5,17
1,0022000128,1610612763,Grizzlies,MEM,Memphis,240.000000:00,115,60,39,21,23,0,13,29,2,7,9,2,16,9,4,18
0,0022000129,1610612762,Jazz,UTA,Utah,240.000000:00,131,73,45,28,14,1,18,43,1,3,4,1,16,12,3,17
1,0022000129,1610612749,Bucks,MIL,Milwaukee,240.000000:00,118,77,35,42,8,0,9,22,4,5,9,3,13,9,4,16
0,0022000130,1610612746,Clippers,LAC,LA,240.000000:00,105,38,18,20,18,0,8,19,6,4,10,2,7,4,0,9
1,0022000130,1610612744,Warriors,GSW,Golden State,240.000000:00,115,53,30,23,18,0,9,24,5,4,9,0,14,12,5,14
0,0022000131,1610612741,Bulls,CHI,Chicago,240.000000:00,115,59,39,20,15,1,7,17,6,6,12,1,5,3,2,6
1,0022000131,1610612747,Lakers,LAL,Los Angeles,240.000000:00,117,59,40,19,15,2,13,30,3,6,9,5,2,6,4,7
0,0022000132,1610612761,Raptors,TOR,Toronto,240.000000:00,144,54,30,24,13,0,8,19,5,2,7,3,11,12,5,14
1,0022000132,1610612758,Kings,SAC,Sacramento,240.000000:00,123,59,29,30,17,1,6,14,2,2,4,1,2,2,1,3
0,0022000133,1610612743,Nuggets,DEN,Denver,240.000000:00,115,58,32,26,17,0,5,10,4,3,7,1,9,10,6,10
1,0022000133,1610612755,76ers,PHI,Philadelphia,240.000000:00,103,62,40,22,11,1,12,26,2,3,5,3,7,7,6,10
0,0022000134,1610612737,Hawks,ATL,Atlanta,240.000000:00,105,52,28,24,13,0,2,5,7,3,10,1,5,3,3,6
1,0022000134,1610612766,Hornets,CHA,Charlotte,240.000000:00,113,61,35,26,13,2,6,14,4,3,7,0,12,7,1,12
0,0022000135,1610612756,Suns,PHX,Phoenix,240.000000:00,125,47,34,13,12,2,5,10,1,3,4,1,6,6,4,7
1,0022000135,1610612754,Pacers,IND,Indiana,240.000000:00,117,40,25,15,8,0,10,22,1,2,3,0,5,5,2,5
0,0022000136,1610612748,Heat,MIA,Miami,240.000000:00,128,53,35,18,7,0,12,29,5,4,9,3,4,7,4,7
1,0022000136,1610612764,Wizards,WAS,Washington,240.000000:00,124,48,29,19,18,1,9,23,1,3,4,1,6,4,1,7
0,0022000137,1610612739,Cavaliers,CLE,Cleveland,240.000000:00,90,62,30,32,24,1,10,21,7,3,10,0,7,5,1,7
1,0022000137,1610612749,Bucks,MIL,Milwaukee,240.000000:00,100,61,44,17,23,0,3,6,7,3,10,1,14,12,4,15
0,0022000138,1610612759,Spurs,SAS,San Antonio,265.000000:00,125,50,41,9,18,0,8,18,2,5,7,3,4,4,4,7
1,0022000138,1610612750,Timberwolves,MIN,Minnesota,265.000000:00,122,52,37,15,9,0,12,25,4,3,7,3,8,9,5,11
0,0022000139,1610612753,Magic,ORL,Orlando,240.000000:00,98,33,14,19,14,0,7,15,2,6,8,4,2,6,4,6
1,0022000139,1610612742,Mavericks,DAL,Dallas,240.000000:00,112,64,40,24,17,0,15,39,2,4,6,1,7,7,3,8
0,0022000140,1610612757,Trail Blazers,POR,Portland,240.000000:00,125,54,30,24,16,0,12,31,0,2,2,1,12,9,3,13
1,0022000140,1610612758,Kings,SAC,Sacramento,240.000000:00,99,72,41,31,13,0,6,12,4,4,8,1,12,12,7,13
0,0022000141,1610612762,Jazz,UTA,Utah,240.000000:00,96,54,25,29,10,0,10,24,5,3,8,0,15,11,7,15
1,0022000141,1610612765,Pistons,DET,Detroit,240.000000:00,86,48,31,17,17,0,10,24,3,5,8,3,11,11,6,14
0,0022000142,1610612741,Bulls,CHI,Chicago,240.000000:00,127,37,24,13,11,1,12,30,2,4,6,0,4,3,0,4
1,0022000142,1610612746,Clippers,LAC,LA,240.000000:00,130,27,17,10,20,0,20,49,4,5,9,4,1,5,3,5
0,0022000143,1610612760,Thunder,OKC,Oklahoma City,240.000000:00,129,57,30,27,21,0,6,14,5,7,12,1,10,6,3,11
1,0022000143,1610612751,Nets,BKN,Brooklyn,240.000000:00,116,60,30,30,10,1,9,23,6,5,11,0,8,7,1,8
0,0022000144,1610612743,Nuggets,DEN,Denver,240.000000:00,114,35,31,4,21,0,10,20,2,3,5,2,4,4,2,6
1,0022000144,1610612752,Knicks,NYK,New York,240.000000:00,89,51,31,20,11,0,6,12,3,0,3,4,5,6,3,9
0,0022000145,1610612748,Heat,MIA,Miami,240.000000:00,130,39,19,20,19,2,16,38,0,4,4,1,17,15,5,18
1,0022000145,1610612738,Celtics,BOS,Boston,240.000000:00,124,61,34,27,11,0,7,15,3,1,4,1,16,13,5,17
0,0022000146,1610612747,Lakers,LAL,Los Angeles,240.000000:00,120,35,21,14,24,0,8,18,3,6,9,1,10,10,4,11
1,0022000146,1610612745,Rockets,HOU,Houston,240.000000:00,102,33,27,6,12,0,5,11,4,5,9,3,15,12,4,18
0,0022000147,1610612759,Spurs,SAS,San Antonio,240.000000:00,88,56,37,19,8,0,7,17,2,3,5,2,11,11,6,13
1,0022000147,1610612750,Timberwolves,MIN,Minnesota,240.000000:00,96,71,47,24,8,0,15,36,3,4,7,2,7,8,5,9
0,0022000148,1610612761,Raptors,TOR,Toronto,240.000000:00,105,60,29,31,18,0,8,18,3,3,6,0,8,6,3,8
1,0022000148,1610612744,Warriors,GSW,Golden State,240.000000:00,106,60,36,24,16,1,4,9,3,1,4,0,2,2,1,2
0,0022000149,1610612752,Knicks,NYK,New York,240.000000:00,88,35,17,18,17,0,3,6,1,3,4,1,10,8,3,11
1,0022000149,1610612766,Hornets,CHA,Charlotte,240.000000:00,109,36,23,13,12,2,6,15,4,3,7,1,18,15,5,19
0,0022000150,1610612763,Grizzlies,MEM,Memphis,240.000000:00,101,55,37,18,27,0,9,18,3,2,5,0,9,4,1,9
1,0022000150,1610612739,Cavaliers,CLE,Cleveland,240.000000:00,91,46,31,15,16,1,10,24,6,8,14,1,7,7,5,8
0,0022000151,1610612749,Bucks,MIL,Milwaukee,240.000000:00,121,65,40,25,22,0,9,21,6,8,14,4,17,17,9,21
1,0022000151,1610612753,Magic,ORL,Orlando,240.000000:00,99,58,36,22,18,1,9,20,5,3,8,2,12,10,4,14
0,0022000152,1610612756,Suns,PHX,Phoenix,240.000000:00,107,47,30,17,12,0,13,26,2,0,2,1,6,6,3,7
1,0022000152,1610612764,Wizards,WAS,Washington,240.000000:00,128,51,37,14,8,0,12,30,4,0,4,4,17,18,8,21
0,0022000153,1610612755,76ers,PHI,Philadelphia,240.000000:00,94,77,38,39,9,0,14,32,4,0,4,1,13,12,5,14
1,0022000153,1610612737,Hawks,ATL,Atlanta,240.000000:00,112,62,37,25,13,0,13,32,2,2,4,2,12,10,1,14
0,0022000154,1610612740,Pelicans,NOP,New Orleans,240.000000:00,107,56,29,27,8,0,12,27,4,2,6,0,11,8,1,11
1,0022000154,1610612742,Mavericks,DAL,Dallas,240.000000:00,125,52,34,18,6,0,21,52,1,1,2,0,20,12,6,20
0,0022000155,1610612761,Raptors,TOR,Toronto,240.000000:00,111,62,30,32,12,0,4,9,2,3,5,0,4,3,1,4
1,0022000155,1610612757,Trail Blazers,POR,Portland,240.000000:00,112,57,24,33,21,0,5,12,1,5,6,1,8,9,6,9
0,0022000156,1610612754,Pacers,IND,Indiana,240.000000:00,122,47,32,15,24,0,14,34,2,5,7,2,10,11,3,12
1,0022000156,1610612758,Kings,SAC,Sacramento,240.000000:00,127,61,35,26,17,2,12,28,7,7,14,1,13,11,6,14
0,0022000157,1610612748,Heat,MIA,Miami,265.000000:00,134,67,27,40,11,1,17,42,1,3,4,1,8,4,2,9
1,0022000157,1610612755,76ers,PHI,Philadelphia,265.000000:00,137,67,32,35,12,0,15,36,3,3,6,4,6,10,7,10
0,0022000158,1610612743,Nuggets,DEN,Denver,240.000000:00,116,56,30,26,16,0,16,38,3,4,7,3,4,6,6,7
1,0022000158,1610612751,Nets,BKN,Brooklyn,240.000000:00,122,70,37,33,14,0,10,25,2,1,3,0,16,12,6,16
0,0022000159,1610612762,Jazz,UTA,Utah,240.000000:00,117,64,41,23,12,0,7,19,3,2,5,2,7,4,1,9
1,0022000159,1610612739,Cavaliers,CLE,Cleveland,240.000000:00,87,49,20,29,15,0,9,18,4,3,7,1,7,4,2,8
0,0022000160,1610612738,Celtics,BOS,Boston,240.000000:00,99,56,36,20,12,1,17,41,6,3,9,1,3,3,2,4
1,0022000160,1610612741,Bulls,CHI,Chicago,240.000000:00,121,45,24,21,15,0,10,22,2,1,3,0,2,2,1,2
0,0022000161,1610612747,Lakers,LAL,Los Angeles,240.000000:00,117,63,38,25,18,0,9,24,5,2,7,1,2,3,1,3
1,0022000161,1610612745,Rockets,HOU,Houston,240.000000:00,100,44,28,16,18,1,6,15,3,5,8,1,6,3,0,7
0,0022000162,1610612759,Spurs,SAS,San Antonio,240.000000:00,112,47,35,12,15,0,12,24,3,1,4,2,5,5,3,7
1,0022000162,1610612760,Thunder,OKC,Oklahoma City,240.000000:00,102,65,43,22,7,1,12,24,1,3,4,0,6,4,2,6
0,0022000163,1610612754,Pacers,IND,Indiana,240.000000:00,104,46,29,17,22,0,5,13,5,1,6,2,8,10,6,10
1,0022000163,1610612744,Warriors,GSW,Golden State,240.000000:00,95,46,32,14,19,0,7,16,2,2,4,3,17,16,8,20
0,0022000164,1610612742,Mavericks,DAL,Dallas,240.000000:00,104,62,41,21,10,1,10,23,4,9,13,2,4,4,2,6
1,0022000164,1610612766,Hornets,CHA,Charlotte,240.000000:00,93,62,30,32,13,0,9,20,1,1,2,2,9,8,3,11
0,0022000165,1610612749,Bucks,MIL,Milwaukee,240.000000:00,110,53,33,20,16,0,5,13,4,5,9,1,12,10,2,13
1,0022000165,1610612765,Pistons,DET,Detroit,240.000000:00,101,43,19,24,15,1,10,24,2,5,7,2,14,16,4,16
0,0022000166,1610612762,Jazz,UTA,Utah,240.000000:00,122,46,40,6,14,1,18,42,3,5,8,1,2,3,3,3
1,0022000166,1610612764,Wizards,WAS,Washington,240.000000:00,131,50,29,21,9,2,13,31,3,3,6,1,5,5,2,6
0,0022000167,1610612753,Magic,ORL,Orlando,240.000000:00,96,36,15,21,12,0,6,16,4,1,5,4,1,4,4,5
1,0022000167,1610612738,Celtics,BOS,Boston,240.000000:00,112,46,30,16,14,0,17,48,0,4,4,1,5,5,3,6
0,0022000168,1610612751,Nets,BKN,Brooklyn,240.000000:00,116,51,35,16,10,0,9,21,2,2,4,1,9,9,5,10
1,0022000168,1610612752,Knicks,NYK,New York,240.000000:00,109,60,33,27,7,0,14,32,2,4,6,1,6,6,3,7
0,0022000169,1610612763,Grizzlies,MEM,Memphis,240.000000:00,118,55,27,28,17,0,10,21,4,5,9,1,11,10,7,12
1,0022000169,1610612750,Timberwolves,MIN,Minnesota,240.000000:00,107,62,45,17,9,0,14,33,5,4,9,0,5,3,1,5
0,0022000170,1610612747,Lakers,LAL,Los Angeles,240.000000:00,128,51,32,19,15,3,8,18,2,5,7,2,9,8,3,11
1,0022000170,1610612760,Thunder,OKC,Oklahoma City,240.000000:00,99,72,49,23,14,0,6,13,4,1,5,0,10,7,2,10
0,0022000171,1610612737,Hawks,ATL,Atlanta,240.000000:00,110,44,28,16,12,0,2,4,2,1,3,0,7,6,5,7
1,0022000171,1610612756,Suns,PHX,Phoenix,240.000000:00,117,52,28,24,13,0,8,16,2,5,7,3,13,15,7,16
0,0022000172,1610612740,Pelicans,NOP,New Orleans,240.000000:00,106,54,28,26,16,0,16,35,4,1,5,3,10,10,7,13
1,0022000172,1610612746,Clippers,LAC,LA,240.000000:00,111,56,38,18,13,1,6,13,3,2,5,1,9,6,2,10
0,0022000173,1610612757,Trail Blazers,POR,Portland,240.000000:00,132,46,23,23,15,1,13,30,3,2,5,2,5,6,3,7
1,0022000173,1610612758,Kings,SAC,Sacramento,240.000000:00,126,54,24,30,8,1,10,22,4,1,5,3,7,9,5,10
0,0022000174,1610612748,Heat,MIA,Miami,240.000000:00,108,50,22,28,11,1,16,38,4,1,5,1,11,8,5,12
1,0022000174,1610612755,76ers,PHI,Philadelphia,240.000000:00,125,47,26,21,23,0,11,22,4,7,11,1,7,7,4,8
0,0022000175,1610612766,Hornets,CHA,Charlotte,240.000000:00,108,51,21,30,18,3,4,8,7,2,9,0,6,5,2,6
1,0022000175,1610612761,Raptors,TOR,Toronto,240.000000:00,111,65,38,27,20,2,4,10,2,6,8,3,8,10,4,11
0,0022000176,1610612745,Rockets,HOU,Houston,240.000000:00,109,51,36,15,10,0,11,26,3,5,8,3,8,11,8,11
1,0022000176,1610612759,Spurs,SAS,San Antonio,240.000000:00,105,52,34,18,26,0,11,24,2,6,8,2,2,4,2,4
0,0022000177,1610612744,Warriors,GSW,Golden State,240.000000:00,104,51,28,23,10,0,7,18,1,3,4,2,13,14,5,15
1,0022000177,1610612743,Nuggets,DEN,Denver,240.000000:00,114,33,17,16,16,1,8,16,4,3,7,1,9,9,2,10
0,0022000178,1610612754,Pacers,IND,Indiana,240.000000:00,111,55,27,28,21,1,11,26,0,7,7,2,7,9,6,9
1,0022000178,1610612757,Trail Blazers,POR,Portland,240.000000:00,87,51,38,13,23,0,5,11,4,2,6,5,12,13,11,17
0,0022000179,1610612764,Wizards,WAS,Washington,240.000000:00,91,64,44,20,15,0,8,18,1,0,1,1,8,7,2,9
1,0022000179,1610612765,Pistons,DET,Detroit,240.000000:00,120,52,40,12,13,1,16,37,2,1,3,0,11,10,1,11
0,0022000180,1610612753,Magic,ORL,Orlando,240.000000:00,97,39,20,19,12,0,11,23,5,4,9,2,2,4,3,4
1,0022000180,1610612738,Celtics,BOS,Boston,240.000000:00,124,51,38,13,13,0,6,17,1,0,1,1,4,5,3,5
0,0022000181,1610612752,Knicks,NYK,New York,240.000000:00,103,41,26,15,13,0,7,14,3,5,8,0,4,2,0,4
1,0022000181,1610612739,Cavaliers,CLE,Cleveland,240.000000:00,106,59,44,15,13,0,6,12,5,7,12,0,2,1,1,2
0,0022000182,1610612742,Mavericks,DAL,Dallas,240.000000:00,109,54,39,15,11,0,14,32,3,1,4,1,10,11,4,11
1,0022000182,1610612749,Bucks,MIL,Milwaukee,240.000000:00,112,61,40,21,12,0,9,20,5,1,6,6,7,13,9,13
0,0022000183,1610612763,Grizzlies,MEM,Memphis,240.000000:00,139,65,36,29,15,0,8,16,3,4,7,3,4,5,2,7
1,0022000183,1610612750,Timberwolves,MIN,Minnesota,240.000000:00,135,53,41,12,15,0,9,22,3,4,7,0,3,1,1,3
0,0022000184,1610612741,Bulls,CHI,Chicago,265.000000:00,125,77,41,36,11,0,14,35,3,3,6,4,7,8,6,11
1,0022000184,1610612760,Thunder,OKC,Oklahoma City,265.000000:00,127,72,35,37,19,1,16,35,3,6,9,0,6,3,2,6
0,0022000185,1610612744,Warriors,GSW,Golden State,240.000000:00,98,48,35,13,14,0,11,28,2,3,5,4,4,6,2,8
1,0022000185,1610612756,Suns,PHX,Phoenix,240.000000:00,120,43,25,18,16,0,9,18,4,1,5,5,5,10,7,10
0,0022000186,1610612737,Hawks,ATL,Atlanta,240.000000:00,92,47,26,21,11,1,6,13,7,2,9,0,10,5,2,10
1,0022000186,1610612762,Jazz,UTA,Utah,240.000000:00,116,56,39,17,10,0,12,30,6,5,11,2,4,4,3,6
0,0022000187,1610612740,Pelicans,NOP,New Orleans,240.000000:00,95,49,32,17,15,0,8,17,4,1,5,2,13,8,4,15
1,0022000187,1610612747,Lakers,LAL,Los Angeles,240.000000:00,112,45,27,18,15,2,6,14,4,3,7,1,6,7,3,7
0,0022000188,1610612746,Clippers,LAC,LA,240.000000:00,138,56,36,20,18,0,10,25,2,2,4,1,7,3,2,8
1,0022000188,1610612758,Kings,SAC,Sacramento,240.000000:00,100,60,35,25,12,0,8,18,2,0,2,0,3,0,0,3
0,0022000189,1610612745,Rockets,HOU,Houston,240.000000:00,91,61,50,11,18,0,8,21,3,4,7,0,14,8,1,14
1,0022000189,1610612759,Spurs,SAS,San Antonio,240.000000:00,103,65,41,24,18,1,9,18,8,4,12,1,11,10,4,12
0,0022000190,1610612753,Magic,ORL,Orlando,240.000000:00,115,40,16,24,18,0,16,36,2,1,3,3,1,4,3,4
1,0022000190,1610612751,Nets,BKN,Brooklyn,240.000000:00,122,53,32,21,14,0,9,21,3,1,4,0,17,11,5,17
0,0022000191,1610612766,Hornets,CHA,Charlotte,240.000000:00,113,32,17,15,10,2,8,21,4,3,7,4,15,15,3,19
1,0022000191,1610612761,Raptors,TOR,Toronto,240.000000:00,116,48,28,20,14,0,3,9,4,7,11,4,9,10,4,13
0,0022000192,1610612765,Pistons,DET,Detroit,240.000000:00,120,37,21,16,11,1,15,37,4,3,7,5,2,7,5,7
1,0022000192,1610612748,Heat,MIA,Miami,240.000000:00,100,49,21,28,9,2,9,21,3,1,4,0,10,6,3,10
0,0022000193,1610612755,76ers,PHI,Philadelphia,240.000000:00,104,56,37,19,16,1,23,51,2,4,6,2,4,5,1,6
1,0022000193,1610612763,Grizzlies,MEM,Memphis,240.000000:00,106,58,38,20,23,1,11,23,2,4,6,0,7,7,3,7
0,0022000194,1610612754,Pacers,IND,Indiana,240.000000:00,122,51,34,17,22,0,11,28,1,3,4,1,6,7,5,7
1,0022000194,1610612756,Suns,PHX,Phoenix,240.000000:00,111,38,25,13,13,1,10,20,6,2,8,3,5,6,3,8
0,0022000195,1610612737,Hawks,ATL,Atlanta,240.000000:00,106,55,31,24,13,0,8,17,1,3,4,3,10,12,5,13
1,0022000195,1610612757,Trail Blazers,POR,Portland,240.000000:00,112,43,26,17,20,1,8,19,1,5,6,2,8,7,4,10
0,0022000196,1610612752,Knicks,NYK,New York,240.000000:00,105,40,17,23,20,0,5,11,6,3,9,0,9,8,4,9
1,0022000196,1610612738,Celtics,BOS,Boston,240.000000:00,75,36,18,18,21,1,9,21,1,2,3,3,5,7,4,8
0,0022000197,1610612739,Cavaliers,CLE,Cleveland,240.000000:00,110,51,38,13,12,0,8,20,5,0,5,2,5,7,4,7
1,0022000197,1610612764,Wizards,WAS,Washington,240.000000:00,119,46,33,13,16,1,12,26,3,4,7,0,6,5,2,6
0,0022000198,1610612741,Bulls,CHI,Chicago,240.000000:00,117,74,45,29,23,0,14,28,2,3,5,0,12,10,1,12
1,0022000198,1610612742,Mavericks,DAL,Dallas,240.000000:00,101,65,46,19,18,1,13,28,1,3,4,1,10,11,5,11
0,0022000199,1610612755,76ers,PHI,Philadelphia,240.000000:00,117,39,28,11,21,0,13,28,3,3,6,1,4,3,1,5
1,0022000199,1610612760,Thunder,OKC,Oklahoma City,240.000000:00,93,47,27,20,13,0,12,27,2,1,3,0,8,5,3,8
0,0022000200,1610612762,Jazz,UTA,Utah,240.000000:00,109,57,33,24,12,1,12,30,3,2,5,1,3,4,2,4
1,0022000200,1610612743,Nuggets,DEN,Denver,240.000000:00,105,40,19,21,19,0,15,33,4,6,10,3,16,15,4,19
0,0022000201,1610612740,Pelicans,NOP,New Orleans,240.000000:00,128,55,32,23,10,0,12,26,4,8,12,2,11,12,8,13
1,0022000201,1610612758,Kings,SAC,Sacramento,240.000000:00,123,60,44,16,8,2,9,23,3,5,8,1,9,8,6,10
0,0022000202,1610612754,Pacers,IND,Indiana,240.000000:00,96,68,40,28,26,0,11,27,2,6,8,1,8,9,5,9
1,0022000202,1610612746,Clippers,LAC,LA,240.000000:00,129,61,33,28,12,1,9,20,6,1,7,0,13,11,1,13
0,0022000203,1610612753,Magic,ORL,Orlando,240.000000:00,84,49,39,10,13,0,4,10,0,2,2,1,2,3,2,3
1,0022000203,1610612752,Knicks,NYK,New York,240.000000:00,91,45,25,20,10,0,10,23,5,1,6,4,4,6,6,8
0,0022000204,1610612739,Cavaliers,CLE,Cleveland,240.000000:00,105,59,42,17,11,1,18,38,3,2,5,1,11,10,4,12
1,0022000204,1610612764,Wizards,WAS,Washington,240.000000:00,120,56,34,22,16,0,5,12,2,3,5,0,14,14,2,14
0,0022000205,1610612750,Timberwolves,MIN,Minnesota,240.000000:00,97,43,25,18,19,1,13,33,3,5,8,1,7,6,0,8
1,0022000205,1610612737,Hawks,ATL,Atlanta,240.000000:00,108,49,33,16,11,0,9,23,3,3,6,1,3,3,2,4
0,0022000206,1610612765,Pistons,DET,Detroit,240.000000:00,107,53,29,24,16,1,8,21,4,0,4,0,7,6,0,7
1,0022000206,1610612748,Heat,MIA,Miami,240.000000:00,113,57,31,26,17,1,14,31,3,3,6,1,12,8,3,13
0,0022000207,1610612759,Spurs,SAS,San Antonio,240.000000:00,125,60,38,22,8,0,13,30,2,1,3,2,10,10,5,12
1,0022000207,1610612757,Trail Blazers,POR,Portland,240.000000:00,104,67,38,29,13,0,14,32,2,5,7,1,3,3,2,4
0,0022000208,1610612756,Suns,PHX,Phoenix,240.000000:00,104,66,45,21,16,1,4,8,2,3,5,0,7,4,1,7
1,0022000208,1610612763,Grizzlies,MEM,Memphis,240.000000:00,108,63,35,28,18,1,11,23,4,3,7,1,5,6,4,6
0,0022000209,1610612749,Bucks,MIL,Milwaukee,240.000000:00,123,71,49,22,18,1,10,21,2,4,6,2,6,7,5,8
1,0022000209,1610612751,Nets,BKN,Brooklyn,240.000000:00,125,75,53,22,9,0,11,27,6,3,9,1,8,8,4,9
0,0022000210,1610612742,Mavericks,DAL,Dallas,240.000000:00,93,47,27,20,12,1,5,10,6,5,11,0,11,7,3,11
1,0022000210,1610612761,Raptors,TOR,Toronto,240.000000:00,116,52,26,26,18,1,8,20,3,7,10,0,10,3,1,10
0,0022000211,1610612745,Rockets,HOU,Houston,240.000000:00,120,71,34,37,11,1,16,37,3,3,6,1,13,12,7,14
1,0022000211,1610612741,Bulls,CHI,Chicago,240.000000:00,125,61,31,30,11,1,14,35,3,6,9,1,8,7,3,9
0,0022000212,1610612744,Warriors,GSW,Golden State,240.000000:00,115,38,28,10,20,1,11,25,3,1,4,0,13,10,4,13
1,0022000212,1610612747,Lakers,LAL,Los Angeles,240.000000:00,113,34,23,11,11,3,5,11,4,2,6,1,13,11,3,14
0,0022000213,1610612760,Thunder,OKC,Oklahoma City,240.000000:00,101,64,34,30,21,0,8,19,2,2,4,0,6,5,1,6
1,0022000213,1610612743,Nuggets,DEN,Denver,240.000000:00,119,39,20,19,27,2,9,19,3,2,5,3,3,6,3,6
0,0022000214,1610612740,Pelicans,NOP,New Orleans,240.000000:00,102,58,24,34,12,0,12,26,2,2,4,2,6,5,2,8
1,0022000214,1610612762,Jazz,UTA,Utah,240.000000:00,118,62,48,14,11,1,1,2,5,1,6,3,11,14,9,14
0,0022000215,1610612764,Wizards,WAS,Washington,240.000000:00,97,65,47,18,11,2,5,11,4,2,6,1,15,11,1,16
1,0022000215,1610612766,Hornets,CHA,Charlotte,240.000000:00,119,57,34,23,14,1,9,20,7,3,10,0,6,4,1,6
0,0022000216,1610612751,Nets,BKN,Brooklyn,290.000000:00,135,66,38,28,14,0,10,24,5,1,6,2,6,7,3,8
1,0022000216,1610612739,Cavaliers,CLE,Cleveland,290.000000:00,147,57,35,22,16,0,13,31,3,2,5,2,5,6,2,7
0,0022000217,1610612742,Mavericks,DAL,Dallas,240.000000:00,124,55,35,20,9,0,7,14,4,1,5,0,9,7,2,9
1,0022000217,1610612754,Pacers,IND,Indiana,240.000000:00,112,49,29,20,15,0,8,20,1,4,5,1,4,5,2,5
0,0022000218,1610612738,Celtics,BOS,Boston,240.000000:00,109,34,25,9,11,1,12,29,4,4,8,1,12,11,2,13
1,0022000218,1610612755,76ers,PHI,Philadelphia,240.000000:00,117,33,21,12,22,0,7,17,1,6,7,6,7,10,5,13
0,0022000219,1610612765,Pistons,DET,Detroit,265.000000:00,115,47,38,9,14,0,17,39,5,2,7,2,8,9,8,10
1,0022000219,1610612737,Hawks,ATL,Atlanta,265.000000:00,123,63,41,22,17,0,10,21,6,2,8,0,6,6,4,6
0,0022000220,1610612748,Heat,MIA,Miami,240.000000:00,111,33,18,15,10,2,4,10,2,3,5,2,12,9,3,14
1,0022000220,1610612761,Raptors,TOR,Toronto,240.000000:00,102,30,12,18,17,4,6,14,2,3,5,0,14,14,5,14
0,0022000221,1610612753,Magic,ORL,Orlando,240.000000:00,97,50,31,19,10,0,17,37,5,5,10,0,6,5,3,6
1,0022000221,1610612750,Timberwolves,MIN,Minnesota,240.000000:00,96,55,40,15,10,0,12,30,3,4,7,0,8,7,2,8
0,0022000222,1610612756,Suns,PHX,Phoenix,240.000000:00,109,57,35,22,19,0,7,15,4,3,7,0,7,4,0,7
1,0022000222,1610612745,Rockets,HOU,Houston,240.000000:00,103,44,21,23,13,0,10,24,2,5,7,1,4,3,2,5
0,0022000223,1610612759,Spurs,SAS,San Antonio,240.000000:00,99,63,39,24,14,0,7,14,2,2,4,0,3,3,0,3
1,0022000223,1610612744,Warriors,GSW,Golden State,240.000000:00,121,69,40,29,14,0,12,29,5,4,9,4,6,7,4,10
0,0022000224,1610612758,Kings,SAC,Sacramento,240.000000:00,96,49,33,16,19,1,13,32,2,7,9,0,10,8,3,10
1,0022000224,1610612746,Clippers,LAC,LA,240.000000:00,115,57,38,19,14,0,11,27,2,0,2,3,7,10,3,10
0,0022000225,1610612763,Grizzlies,MEM,Memphis,240.000000:00,130,63,39,24,21,0,12,27,2,2,4,1,15,11,1,16
1,0022000225,1610612757,Trail Blazers,POR,Portland,240.000000:00,128,56,37,19,14,0,13,33,2,2,4,2,13,7,4,15
0,0022000226,1610612747,Lakers,LAL,Los Angeles,240.000000:00,113,55,39,16,16,2,8,21,4,4,8,1,16,10,3,17
1,0022000226,1610612749,Bucks,MIL,Milwaukee,240.000000:00,106,67,44,23,13,0,8,16,7,4,11,1,18,11,6,19
0,0022000227,1610612740,Pelicans,NOP,New Orleans,240.000000:00,118,48,24,24,14,0,11,27,3,6,9,0,10,9,6,10
1,0022000227,1610612762,Jazz,UTA,Utah,240.000000:00,129,46,34,12,11,0,14,38,1,4,5,0,12,11,3,12
0,0022000228,1610612752,Knicks,NYK,New York,240.000000:00,119,50,30,20,19,0,10,23,3,2,5,0,7,5,3,7
1,0022000228,1610612744,Warriors,GSW,Golden State,240.000000:00,104,56,38,18,20,0,11,25,2,4,6,0,6,5,1,6
0,0022000229,1610612741,Bulls,CHI,Chicago,240.000000:00,123,49,30,19,12,2,4,9,5,6,11,1,3,4,1,4
1,0022000229,1610612766,Hornets,CHA,Charlotte,240.000000:00,110,48,31,17,17,1,19,43,6,1,7,3,10,12,7,13
0,0022000230,1610612745,Rockets,HOU,Houston,240.000000:00,103,49,31,18,17,2,12,27,1,1,2,2,10,7,3,12
1,0022000230,1610612765,Pistons,DET,Detroit,240.000000:00,102,58,27,31,15,2,10,25,3,1,4,2,5,5,3,7
0,0022000231,1610612753,Magic,ORL,Orlando,265.000000:00,118,43,24,19,11,0,8,19,3,3,6,0,7,7,5,7
1,0022000231,1610612754,Pacers,IND,Indiana,265.000000:00,120,51,31,20,19,1,10,25,2,4,6,3,8,9,4,11
0,0022000232,1610612751,Nets,BKN,Brooklyn,240.000000:00,113,51,34,17,6,1,12,26,0,2,2,0,6,4,2,6
1,0022000232,1610612739,Cavaliers,CLE,Cleveland,240.000000:00,125,56,29,27,15,1,11,24,1,4,5,2,3,5,4,5
0,0022000233,1610612738,Celtics,BOS,Boston,240.000000:00,110,63,39,24,20,0,17,40,0,3,3,0,11,9,3,11
1,0022000233,1610612755,76ers,PHI,Philadelphia,240.000000:00,122,54,32,22,13,0,6,12,1,4,5,0,5,5,2,5
0,0022000234,1610612748,Heat,MIA,Miami,240.000000:00,81,55,27,28,25,1,7,15,3,3,6,1,7,4,2,8
1,0022000234,1610612761,Raptors,TOR,Toronto,240.000000:00,101,50,26,24,20,1,8,19,4,3,7,1,11,10,3,12
0,0022000235,1610612764,Wizards,WAS,Washington,240.000000:00,134,58,34,24,13,3,17,38,2,4,6,0,2,2,0,2
1,0022000235,1610612749,Bucks,MIL,Milwaukee,240.000000:00,135,59,49,10,9,0,11,26,3,3,6,2,3,5,3,5
0,0022000236,1610612737,Hawks,ATL,Atlanta,240.000000:00,116,55,35,20,16,0,11,29,5,3,8,1,14,13,6,15
1,0022000236,1610612750,Timberwolves,MIN,Minnesota,240.000000:00,98,54,30,24,21,0,4,10,3,3,6,2,10,7,5,12
0,0022000237,1610612742,Mavericks,DAL,Dallas,240.000000:00,122,60,41,19,5,1,15,33,1,1,2,1,5,3,2,6
1,0022000237,1610612759,Spurs,SAS,San Antonio,240.000000:00,117,50,29,21,6,0,9,21,3,2,5,1,4,5,3,5
0,0022000238,1610612743,Nuggets,DEN,Denver,265.000000:00,130,56,25,31,20,0,12,24,1,3,4,1,6,6,4,7
1,0022000238,1610612756,Suns,PHX,Phoenix,265.000000:00,126,71,49,22,13,0,9,18,2,3,5,2,7,7,3,9
0,0022000239,1610612760,Thunder,OKC,Oklahoma City,240.000000:00,106,53,33,20,16,0,9,19,1,5,6,0,9,7,1,9
1,0022000239,1610612746,Clippers,LAC,LA,240.000000:00,120,63,33,30,12,0,6,14,3,6,9,3,6,5,3,9
0,0022000240,1610612763,Grizzlies,MEM,Memphis,240.000000:00,120,77,53,24,14,0,13,29,2,3,5,0,10,10,5,10
1,0022000240,1610612757,Trail Blazers,POR,Portland,240.000000:00,113,43,35,8,17,1,15,38,6,4,10,2,11,10,8,13
0,0022000241,1610612752,Knicks,NYK,New York,240.000000:00,94,37,25,12,8,0,5,10,4,1,5,5,19,17,7,24
1,0022000241,1610612758,Kings,SAC,Sacramento,240.000000:00,103,52,43,9,22,2,9,19,1,5,6,2,24,23,8,26
0,0022000242,1610612744,Warriors,GSW,Golden State,240.000000:00,108,60,25,35,17,1,15,36,5,4,9,0,15,13,2,15
1,0022000242,1610612762,Jazz,UTA,Utah,240.000000:00,127,55,32,23,15,0,16,40,4,6,10,4,8,11,6,12
0,0022000243,1610612755,76ers,PHI,Philadelphia,240.000000:00,114,50,29,21,21,1,10,22,5,4,9,1,5,5,3,6
1,0022000243,1610612765,Pistons,DET,Detroit,240.000000:00,110,56,36,20,14,0,11,27,3,3,6,1,4,5,2,5
0,0022000244,1610612748,Heat,MIA,Miami,240.000000:00,124,50,25,25,19,1,11,27,3,3,6,1,8,8,3,9
1,0022000244,1610612751,Nets,BKN,Brooklyn,240.000000:00,128,49,26,23,6,1,8,22,3,1,4,1,15,12,3,16
0,0022000245,1610612747,Lakers,LAL,Los Angeles,240.000000:00,101,34,30,4,17,5,6,12,1,4,5,1,12,11,5,13
1,0022000245,1610612741,Bulls,CHI,Chicago,240.000000:00,90,37,30,7,16,3,7,15,2,1,3,2,18,18,5,20
0,0022000246,1610612740,Pelicans,NOP,New Orleans,240.000000:00,110,65,36,29,19,0,14,32,3,4,7,4,5,8,5,9
1,0022000246,1610612750,Timberwolves,MIN,Minnesota,240.000000:00,120,57,32,25,21,0,4,9,2,5,7,3,10,9,1,13
0,0022000247,1610612745,Rockets,HOU,Houston,240.000000:00,133,39,26,13,9,1,8,19,1,1,2,2,11,10,7,13
1,0022000247,1610612742,Mavericks,DAL,Dallas,240.000000:00,108,40,20,20,16,1,11,23,4,3,7,2,8,4,2,10
0,0022000248,1610612743,Nuggets,DEN,Denver,290.000000:00,120,63,31,32,11,0,9,22,1,6,7,9,1,10,8,10
1,0022000248,1610612756,Suns,PHX,Phoenix,290.000000:00,112,58,39,19,16,2,10,21,3,6,9,1,8,6,2,9
0,0022000249,1610612761,Raptors,TOR,Toronto,240.000000:00,107,54,31,23,24,1,3,7,2,1,3,5,18,14,6,23
1,0022000249,1610612754,Pacers,IND,Indiana,240.000000:00,102,55,35,20,17,0,11,23,2,3,5,1,4,5,4,5
0,0022000250,1610612739,Cavaliers,CLE,Cleveland,240.000000:00,103,55,36,19,17,0,4,9,6,4,10,2,11,8,4,13
1,0022000250,1610612738,Celtics,BOS,Boston,240.000000:00,141,53,32,21,24,0,19,46,6,7,13,2,7,8,5,9
0,0022000251,1610612760,Thunder,OKC,Oklahoma City,240.000000:00,100,72,36,36,8,0,12,25,3,3,6,0,17,16,3,17
1,0022000251,1610612746,Clippers,LAC,LA,240.000000:00,108,67,43,24,12,2,9,20,1,1,2,2,10,11,5,12
0,0022000252,1610612766,Hornets,CHA,Charlotte,240.000000:00,107,60,37,23,20,0,14,34,3,1,4,1,5,3,2,6
1,0022000252,1610612753,Magic,ORL,Orlando,240.000000:00,104,40,21,19,12,0,9,19,1,3,4,0,7,5,2,7
0,0022000253,1610612764,Wizards,WAS,Washington,240.000000:00,101,71,53,18,8,0,9,21,5,5,10,2,7,8,2,9
1,0022000253,1610612759,Spurs,SAS,San Antonio,240.000000:00,121,59,38,21,20,0,12,27,1,6,7,1,9,6,4,10
0,0022000254,1610612737,Hawks,ATL,Atlanta,240.000000:00,115,58,38,20,13,3,11,24,2,3,5,0,9,7,1,9
1,0022000254,1610612749,Bucks,MIL,Milwaukee,240.000000:00,129,63,35,28,10,0,12,29,2,1,3,4,5,8,6,9
0,0022000255,1610612758,Kings,SAC,Sacramento,240.000000:00,110,54,31,23,15,0,15,33,3,0,3,0,2,2,0,2
1,0022000255,1610612763,Grizzlies,MEM,Memphis,240.000000:00,116,76,43,33,12,0,11,24,0,1,1,1,4,5,2,5
0,0022000256,1610612752,Knicks,NYK,New York,240.000000:00,113,54,22,32,16,0,7,18,2,1,3,2,13,13,9,15
1,0022000256,1610612757,Trail Blazers,POR,Portland,240.000000:00,116,33,21,12,11,1,11,26,3,2,5,1,1,1,1,2
0,0022000257,1610612755,76ers,PHI,Philadelphia,240.000000:00,104,47,20,27,21,0,16,36,4,4,8,2,8,8,4,10
1,0022000257,1610612765,Pistons,DET,Detroit,240.000000:00,119,55,37,18,14,2,8,19,5,1,6,2,13,11,7,15
0,0022000258,1610612761,Raptors,TOR,Toronto,240.000000:00,114,41,26,15,18,0,7,15,6,5,11,0,22,8,1,22
1,0022000258,1610612754,Pacers,IND,Indiana,240.000000:00,129,52,33,19,13,0,8,18,1,3,4,3,14,11,8,17
0,0022000259,1610612766,Hornets,CHA,Charlotte,240.000000:00,108,49,30,19,14,2,9,22,3,2,5,2,15,14,5,17
1,0022000259,1610612753,Magic,ORL,Orlando,240.000000:00,117,49,32,17,13,0,6,17,3,4,7,1,8,9,3,9
0,0022000260,1610612748,Heat,MIA,Miami,240.000000:00,85,49,25,24,20,0,6,16,2,2,4,1,6,6,3,7
1,0022000260,1610612751,Nets,BKN,Brooklyn,240.000000:00,98,51,23,28,9,0,4,8,1,1,2,3,4,6,5,7
0,0022000261,1610612747,Lakers,LAL,Los Angeles,240.000000:00,115,53,40,13,18,0,9,21,5,3,8,2,8,7,5,10
1,0022000261,1610612739,Cavaliers,CLE,Cleveland,240.000000:00,108,51,31,20,11,0,4,8,4,3,7,1,8,4,1,9
0,0022000262,1610612738,Celtics,BOS,Boston,240.000000:00,119,49,27,22,17,0,11,25,4,2,6,1,6,6,0,7
1,0022000262,1610612741,Bulls,CHI,Chicago,240.000000:00,103,51,38,13,10,2,14,37,1,3,4,3,10,5,3,13
0,0022000263,1610612758,Kings,SAC,Sacramento,240.000000:00,106,48,26,22,13,0,8,18,4,1,5,0,2,2,0,2
1,0022000263,1610612763,Grizzlies,MEM,Memphis,240.000000:00,107,64,35,29,12,0,6,13,0,2,2,0,1,1,0,1
0,0022000264,1610612759,Spurs,SAS,San Antonio,240.000000:00,110,62,50,12,10,3,4,9,1,4,5,1,2,3,1,3
1,0022000264,1610612740,Pelicans,NOP,New Orleans,240.000000:00,108,61,38,23,17,0,8,18,2,4,6,1,5,3,3,6
0,0022000265,1610612743,Nuggets,DEN,Denver,240.000000:00,117,39,21,18,18,0,11,24,7,3,10,3,3,5,3,6
1,0022000265,1610612742,Mavericks,DAL,Dallas,240.000000:00,113,50,27,23,16,0,12,29,3,2,5,0,4,3,0,4
0,0022000266,1610612750,Timberwolves,MIN,Minnesota,240.000000:00,108,66,40,26,21,0,9,21,4,3,7,2,5,6,4,7
1,0022000266,1610612744,Warriors,GSW,Golden State,240.000000:00,130,72,54,18,23,1,17,42,8,2,10,0,6,5,1,6
0,0022000267,1610612760,Thunder,OKC,Oklahoma City,240.000000:00,125,76,41,35,12,0,1,2,6,4,10,1,9,8,4,10
1,0022000267,1610612757,Trail Blazers,POR,Portland,240.000000:00,122,56,28,28,12,0,15,34,3,1,4,7,7,11,8,14
0,0022000268,1610612746,Clippers,LAC,LA,240.000000:00,99,47,29,18,10,0,6,12,3,2,5,4,14,15,5,18
1,0022000268,1610612737,Hawks,ATL,Atlanta,240.000000:00,108,65,47,18,17,1,9,21,1,5,6,1,11,9,4,12
0,0022000269,1610612764,Wizards,WAS,Washington,240.000000:00,88,71,39,32,11,3,10,22,2,4,6,2,9,7,2,11
1,0022000269,1610612745,Rockets,HOU,Houston,240.000000:00,107,51,39,12,16,0,15,37,4,5,9,3,8,9,4,11
0,0022000270,1610612752,Knicks,NYK,New York,240.000000:00,94,48,19,29,19,0,11,23,4,2,6,0,8,5,2,8
1,0022000270,1610612762,Jazz,UTA,Utah,240.000000:00,108,41,25,16,8,0,7,18,6,3,9,4,5,7,5,9
0,0022000271,1610612754,Pacers,IND,Indiana,240.000000:00,116,51,29,22,8,0,5,13,2,1,3,0,6,5,4,6
1,0022000271,1610612766,Hornets,CHA,Charlotte,240.000000:00,106,40,20,20,15,1,5,11,3,1,4,1,7,6,3,8
0,0022000272,1610612765,Pistons,DET,Detroit,240.000000:00,107,40,32,8,19,1,9,22,1,4,5,2,5,7,6,7
1,0022000272,1610612739,Cavaliers,CLE,Cleveland,240.000000:00,122,47,33,14,20,0,11,24,3,1,4,0,2,2,1,2
0,0022000273,1610612758,Kings,SAC,Sacramento,240.000000:00,121,44,32,12,12,1,14,36,3,3,6,4,9,11,5,13
1,0022000273,1610612753,Magic,ORL,Orlando,240.000000:00,107,35,27,8,14,0,12,28,4,3,7,2,8,8,4,10
0,0022000274,1610612751,Nets,BKN,Brooklyn,265.000000:00,132,68,42,26,14,0,9,19,4,2,6,0,10,3,2,10
1,0022000274,1610612737,Hawks,ATL,Atlanta,265.000000:00,128,50,28,22,8,0,9,21,2,3,5,4,5,5,3,9
0,0022000275,1610612743,Nuggets,DEN,Denver,240.000000:00,109,39,17,22,28,0,6,13,4,7,11,3,10,13,6,13
1,0022000275,1610612748,Heat,MIA,Miami,240.000000:00,82,49,24,25,21,1,5,14,3,2,5,1,18,17,6,19
0,0022000276,1610612747,Lakers,LAL,Los Angeles,240.000000:00,106,46,33,13,17,0,6,12,4,3,7,2,11,11,7,13
1,0022000276,1610612755,76ers,PHI,Philadelphia,240.000000:00,107,32,23,9,20,0,8,16,4,3,7,3,7,6,1,10
0,0022000277,1610612749,Bucks,MIL,Milwaukee,240.000000:00,115,53,29,24,21,0,6,15,5,2,7,2,3,5,4,5
1,0022000277,1610612761,Raptors,TOR,Toronto,240.000000:00,108,53,26,27,14,3,14,38,4,4,8,0,9,9,3,9
0,0022000278,1610612741,Bulls,CHI,Chicago,240.000000:00,90,50,32,18,14,1,7,15,4,1,5,2,4,6,3,6
1,0022000278,1610612763,Grizzlies,MEM,Memphis,240.000000:00,101,47,26,21,17,0,8,17,3,0,3,4,5,9,4,9
0,0022000279,1610612764,Wizards,WAS,Washington,240.000000:00,106,58,29,29,16,0,10,22,4,6,10,1,12,2,2,13
1,0022000279,1610612740,Pelicans,NOP,New Orleans,240.000000:00,124,70,42,28,15,0,15,35,2,7,9,4,9,8,5,13
0,0022000280,1610612738,Celtics,BOS,Boston,240.000000:00,106,51,35,16,16,1,13,31,6,5,11,1,1,2,0,2
1,0022000280,1610612759,Spurs,SAS,San Antonio,240.000000:00,110,56,44,12,12,0,9,18,3,3,6,0,6,3,1,6
0,0022000281,1610612760,Thunder,OKC,Oklahoma City,240.000000:00,102,74,44,30,7,0,2,5,4,2,6,1,5,5,4,6
1,0022000281,1610612756,Suns,PHX,Phoenix,240.000000:00,97,62,38,24,10,1,16,37,0,3,3,3,7,8,4,10
0,0022000282,1610612742,Mavericks,DAL,Dallas,240.000000:00,104,52,31,21,7,0,18,40,1,1,2,0,13,9,4,13
1,0022000282,1610612762,Jazz,UTA,Utah,240.000000:00,116,59,41,18,11,0,17,43,3,4,7,1,9,5,3,10
0,0022000283,1610612750,Timberwolves,MIN,Minnesota,240.000000:00,111,53,32,21,15,3,14,35,4,4,8,0,6,2,0,6
1,0022000283,1610612744,Warriors,GSW,Golden State,240.000000:00,123,55,31,24,17,0,11,27,3,2,5,4,5,7,4,9
0,0022000284,1610612747,Lakers,LAL,Los Angeles,240.000000:00,92,55,29,26,11,0,7,18,1,1,2,2,11,10,1,13
1,0022000284,1610612765,Pistons,DET,Detroit,240.000000:00,107,61,39,22,13,0,7,16,2,2,4,1,5,6,2,6
0,0022000285,1610612746,Clippers,LAC,LA,240.000000:00,109,52,33,19,14,0,6,14,4,5,9,3,5,8,3,8
1,0022000285,1610612748,Heat,MIA,Miami,240.000000:00,105,57,27,30,15,1,12,28,2,1,3,3,14,13,6,17
0,0022000286,1610612744,Warriors,GSW,Golden State,240.000000:00,93,62,37,25,12,0,9,23,1,3,4,0,9,9,2,9
1,0022000286,1610612756,Suns,PHX,Phoenix,240.000000:00,114,79,50,29,11,0,7,14,3,3,6,0,13,9,5,13
0,0022000287,1610612757,Trail Blazers,POR,Portland,240.000000:00,101,49,19,30,13,2,15,36,2,2,4,0,6,3,2,6
1,0022000287,1610612745,Rockets,HOU,Houston,240.000000:00,104,60,34,26,12,1,9,19,7,6,13,0,9,6,4,9
0,0022000288,1610612754,Pacers,IND,Indiana,240.000000:00,105,46,23,23,16,0,3,7,1,3,4,1,6,5,1,7
1,0022000288,1610612766,Hornets,CHA,Charlotte,240.000000:00,108,59,34,25,15,2,9,22,4,4,8,3,23,13,5,26
0,0022000289,1610612746,Clippers,LAC,LA,240.000000:00,116,53,33,20,13,0,11,25,3,3,6,4,7,6,4,11
1,0022000289,1610612753,Magic,ORL,Orlando,240.000000:00,90,50,25,25,14,0,13,29,3,1,4,3,4,7,4,7
0,0022000290,1610612737,Hawks,ATL,Atlanta,240.000000:00,116,47,33,14,24,0,8,21,1,3,4,0,6,4,1,6
1,0022000290,1610612764,Wizards,WAS,Washington,240.000000:00,100,41,24,17,19,1,5,11,5,3,8,3,14,15,8,17
0,0022000291,1610612739,Cavaliers,CLE,Cleveland,240.000000:00,81,35,26,9,14,0,7,16,4,0,4,3,5,5,5,8
1,0022000291,1610612752,Knicks,NYK,New York,240.000000:00,102,37,24,13,15,0,8,20,3,4,7,0,3,3,0,3
0,0022000292,1610612758,Kings,SAC,Sacramento,240.000000:00,126,42,31,11,20,0,5,12,3,2,5,2,5,6,5,7
1,0022000292,1610612761,Raptors,TOR,Toronto,240.000000:00,124,38,21,17,24,1,10,26,2,7,9,0,10,8,5,10
0,0022000293,1610612749,Bucks,MIL,Milwaukee,240.000000:00,126,81,40,41,18,1,8,18,5,0,5,0,19,16,1,19
1,0022000293,1610612740,Pelicans,NOP,New Orleans,240.000000:00,131,60,33,27,9,0,12,28,5,5,10,2,9,8,5,11
0,0022000294,1610612755,76ers,PHI,Philadelphia,240.000000:00,118,38,27,11,16,0,10,20,3,1,4,5,10,13,7,15
1,0022000294,1610612750,Timberwolves,MIN,Minnesota,240.000000:00,94,36,32,4,12,0,13,27,3,1,4,1,9,10,5,10
0,0022000295,1610612751,Nets,BKN,Brooklyn,240.000000:00,147,42,26,16,8,0,11,26,0,2,2,1,11,7,2,12
1,0022000295,1610612760,Thunder,OKC,Oklahoma City,240.000000:00,125,65,36,29,9,1,7,14,3,1,4,0,2,2,1,2
0,0022000296,1610612743,Nuggets,DEN,Denver,240.000000:00,109,47,30,17,15,0,12,25,2,3,5,1,6,5,3,7
1,0022000296,1610612759,Spurs,SAS,San Antonio,240.000000:00,119,42,26,16,14,1,8,17,6,3,9,3,7,5,3,10
0,0022000297,1610612742,Mavericks,DAL,Dallas,240.000000:00,101,50,21,29,7,2,10,20,0,3,3,1,3,3,1,4
1,0022000297,1610612762,Jazz,UTA,Utah,240.000000:00,120,53,31,22,8,0,13,32,3,3,6,2,5,4,3,7
0,0022000298,1610612757,Trail Blazers,POR,Portland,240.000000:00,123,53,17,36,22,0,19,46,4,3,7,2,9,6,3,11
1,0022000298,1610612741,Bulls,CHI,Chicago,240.000000:00,122,69,38,31,8,2,12,28,2,3,5,3,8,10,5,11
0,0022000299,1610612749,Bucks,MIL,Milwaukee,240.000000:00,114,67,32,35,10,0,3,8,4,1,5,4,4,7,4,8
1,0022000299,1610612766,Hornets,CHA,Charlotte,240.000000:00,126,47,19,28,20,0,10,27,3,5,8,0,8,8,4,8
0,0022000300,1610612745,Rockets,HOU,Houston,240.000000:00,126,53,30,23,14,2,9,24,5,5,10,4,13,14,8,17
1,0022000300,1610612740,Pelicans,NOP,New Orleans,240.000000:00,112,64,31,33,21,0,12,28,2,7,9,4,2,3,2,6
0,0022000301,1610612758,Kings,SAC,Sacramento,240.000000:00,104,43,26,17,8,0,9,20,4,4,8,2,5,7,2,7
1,0022000301,1610612748,Heat,MIA,Miami,240.000000:00,105,56,26,30,16,1,12,26,3,4,7,1,9,9,4,10
0,0022000302,1610612747,Lakers,LAL,Los Angeles,240.000000:00,96,60,42,18,11,0,4,9,1,2,3,5,6,7,5,11
1,0022000302,1610612738,Celtics,BOS,Boston,240.000000:00,95,59,36,23,12,1,12,24,2,5,7,0,8,4,3,8
0,0022000303,1610612756,Suns,PHX,Phoenix,240.000000:00,111,60,34,26,11,0,11,23,3,5,8,2,3,5,3,5
1,0022000303,1610612742,Mavericks,DAL,Dallas,240.000000:00,105,53,39,14,15,0,19,41,0,4,4,1,6,5,3,7
0,0022000304,1610612763,Grizzlies,MEM,Memphis,240.000000:00,129,56,33,23,16,1,16,35,3,3,6,2,11,10,6,13
1,0022000304,1610612759,Spurs,SAS,San Antonio,240.000000:00,112,56,34,22,11,1,12,27,2,0,2,2,14,8,4,16
0,0022000305,1610612765,Pistons,DET,Detroit,240.000000:00,91,52,34,18,10,0,4,9,0,1,1,1,4,5,1,5
1,0022000305,1610612744,Warriors,GSW,Golden State,240.000000:00,118,60,26,34,14,1,12,29,1,3,4,0,4,2,1,4
0,0022000306,1610612762,Jazz,UTA,Utah,240.000000:00,117,60,40,20,7,0,6,15,0,1,1,1,4,4,2,5
1,0022000306,1610612743,Nuggets,DEN,Denver,240.000000:00,128,49,18,31,13,0,6,16,1,1,2,0,4,2,1,4
0,0022000307,1610612755,76ers,PHI,Philadelphia,240.000000:00,119,43,32,11,20,2,13,27,2,3,5,5,15,19,12,20
1,0022000307,1610612754,Pacers,IND,Indiana,240.000000:00,110,58,42,16,10,0,13,29,5,3,8,1,9,10,5,10
0,0022000308,1610612746,Clippers,LAC,LA,240.000000:00,129,50,34,16,13,0,11,24,1,2,3,2,8,8,5,10
1,0022000308,1610612752,Knicks,NYK,New York,240.000000:00,115,49,28,21,11,0,16,32,4,3,7,2,8,7,4,10
0,0022000309,1610612753,Magic,ORL,Orlando,240.000000:00,102,51,29,22,15,0,6,14,2,2,4,1,7,6,2,8
1,0022000309,1610612761,Raptors,TOR,Toronto,240.000000:00,115,50,30,20,17,0,9,20,4,3,7,0,7,5,0,7
0,0022000310,1610612751,Nets,BKN,Brooklyn,240.000000:00,146,63,43,20,11,0,14,32,3,2,5,0,10,6,2,10
1,0022000310,1610612764,Wizards,WAS,Washington,240.000000:00,149,58,38,20,18,2,12,28,3,2,5,0,9,6,3,9
0,0022000311,1610612739,Cavaliers,CLE,Cleveland,240.000000:00,104,51,28,23,9,2,7,14,5,6,11,2,5,7,4,7
1,0022000311,1610612750,Timberwolves,MIN,Minnesota,240.000000:00,109,57,44,13,21,1,13,32,1,6,7,1,10,8,5,11
0,0022000312,1610612750,Timberwolves,MIN,Minnesota,240.000000:00,98,55,35,20,16,1,11,25,7,3,10,1,12,9,1,13
1,0022000312,1610612739,Cavaliers,CLE,Cleveland,240.000000:00,100,76,51,25,9,0,7,16,7,2,9,1,13,10,8,14
0,0022000313,1610612747,Lakers,LAL,Los Angeles,240.000000:00,107,40,23,17,18,1,7,17,5,4,9,0,6,4,2,6
1,0022000313,1610612737,Hawks,ATL,Atlanta,240.000000:00,99,41,25,16,17,0,5,12,1,1,2,2,6,5,3,8
0,0022000314,1610612766,Hornets,CHA,Charlotte,265.000000:00,129,60,28,32,7,1,6,17,4,2,6,0,9,7,4,9
1,0022000314,1610612748,Heat,MIA,Miami,265.000000:00,121,66,33,33,14,0,3,9,3,3,6,0,11,7,1,11
0,0022000315,1610612752,Knicks,NYK,New York,240.000000:00,102,54,33,21,15,1,11,24,5,3,8,2,11,12,3,13
1,0022000315,1610612741,Bulls,CHI,Chicago,240.000000:00,110,51,36,15,18,0,9,20,6,2,8,3,14,15,2,17
0,0022000316,1610612757,Trail Blazers,POR,Portland,240.000000:00,106,67,33,34,13,0,17,41,2,7,9,1,1,2,2,2
1,0022000316,1610612749,Bucks,MIL,Milwaukee,240.000000:00,134,83,48,35,14,1,9,23,3,9,12,0,4,3,0,4
0,0022000317,1610612758,Kings,SAC,Sacramento,240.000000:00,118,66,47,19,11,2,13,31,4,1,5,2,12,14,8,14
1,0022000317,1610612740,Pelicans,NOP,New Orleans,240.000000:00,109,60,30,30,21,1,9,19,3,3,6,5,7,10,6,12
0,0022000318,1610612745,Rockets,HOU,Houston,240.000000:00,136,57,33,24,13,1,12,32,4,2,6,6,12,9,5,18
1,0022000318,1610612760,Thunder,OKC,Oklahoma City,240.000000:00,106,80,39,41,12,0,8,19,1,3,4,0,6,3,0,6
0,0022000319,1610612756,Suns,PHX,Phoenix,240.000000:00,109,62,36,26,9,0,12,25,6,3,9,2,6,7,2,8
1,0022000319,1610612742,Mavericks,DAL,Dallas,240.000000:00,108,54,36,18,16,1,11,25,3,4,7,0,8,8,5,8
0,0022000320,1610612763,Grizzlies,MEM,Memphis,240.000000:00,133,46,32,14,22,0,10,21,4,2,6,1,16,14,4,17
1,0022000320,1610612759,Spurs,SAS,San Antonio,240.000000:00,102,49,33,16,19,0,6,14,6,5,11,2,5,5,3,7
0,0022000321,1610612765,Pistons,DET,Detroit,240.000000:00,119,49,30,19,6,0,6,14,3,1,4,1,5,4,3,6
1,0022000321,1610612743,Nuggets,DEN,Denver,240.000000:00,134,28,16,12,12,0,12,27,2,1,3,0,8,4,3,8
0,0022000322,1610612763,Grizzlies,MEM,Memphis,240.000000:00,116,39,25,14,22,0,8,17,3,2,5,0,8,5,3,8
1,0022000322,1610612754,Pacers,IND,Indiana,240.000000:00,134,54,37,17,25,0,10,25,7,3,10,3,6,9,5,9
0,0022000323,1610612761,Raptors,TOR,Toronto,240.000000:00,123,54,31,23,21,0,10,26,3,10,13,0,7,5,4,7
1,0022000323,1610612753,Magic,ORL,Orlando,240.000000:00,108,43,15,28,12,1,5,13,5,3,8,1,12,8,3,13
0,0022000324,1610612746,Clippers,LAC,LA,240.000000:00,120,49,28,21,15,0,8,19,7,3,10,2,3,5,3,5
1,0022000324,1610612751,Nets,BKN,Brooklyn,240.000000:00,124,60,40,20,12,0,11,26,4,3,7,1,9,5,4,10
0,0022000325,1610612765,Pistons,DET,Detroit,240.000000:00,105,43,24,19,13,0,10,23,2,3,5,0,8,6,5,8
1,0022000325,1610612762,Jazz,UTA,Utah,240.000000:00,117,56,38,18,24,0,14,37,2,2,4,0,14,7,3,14
0,0022000326,1610612738,Celtics,BOS,Boston,240.000000:00,111,48,25,23,14,1,9,21,2,1,3,1,4,5,1,5
1,0022000326,1610612744,Warriors,GSW,Golden State,240.000000:00,107,62,39,23,16,0,13,33,5,1,6,1,14,7,3,15
0,0022000327,1610612755,76ers,PHI,Philadelphia,240.000000:00,118,40,23,17,16,0,7,14,2,4,6,1,3,4,2,4
1,0022000327,1610612766,Hornets,CHA,Charlotte,240.000000:00,111,45,36,9,13,1,6,12,7,4,11,0,6,4,3,6
0,0022000328,1610612746,Clippers,LAC,LA,240.000000:00,121,48,41,7,5,0,14,33,4,2,6,1,5,5,5,6
1,0022000328,1610612739,Cavaliers,CLE,Cleveland,240.000000:00,99,44,28,16,16,0,15,32,2,2,4,3,1,4,4,4
0,0022000329,1610612754,Pacers,IND,Indiana,240.000000:00,110,79,40,39,12,0,17,37,3,3,6,1,10,10,4,11
1,0022000329,1610612749,Bucks,MIL,Milwaukee,240.000000:00,130,68,47,21,13,0,4,11,6,4,10,0,12,9,3,12
0,0022000330,1610612742,Mavericks,DAL,Dallas,240.000000:00,122,57,28,29,18,0,14,29,2,3,5,0,15,12,5,15
1,0022000330,1610612737,Hawks,ATL,Atlanta,240.000000:00,116,60,34,26,11,1,5,11,4,2,6,3,10,12,9,13
0,0022000331,1610612764,Wizards,WAS,Washington,240.000000:00,103,57,34,23,11,3,5,13,3,1,4,4,15,15,5,19
1,0022000331,1610612748,Heat,MIA,Miami,240.000000:00,100,56,33,23,15,0,5,11,8,4,12,2,12,12,6,14
0,0022000332,1610612752,Knicks,NYK,New York,240.000000:00,107,62,35,27,9,0,17,36,4,0,4,3,13,11,5,16
1,0022000332,1610612741,Bulls,CHI,Chicago,240.000000:00,103,61,42,19,14,0,13,27,5,5,10,1,13,10,3,14
0,0022000333,1610612745,Rockets,HOU,Houston,240.000000:00,87,34,21,13,19,2,9,21,3,5,8,1,11,9,4,12
1,0022000333,1610612760,Thunder,OKC,Oklahoma City,240.000000:00,104,60,30,30,15,0,4,10,2,1,3,1,6,7,1,7
0,0022000334,1610612750,Timberwolves,MIN,Minnesota,240.000000:00,108,50,37,13,16,1,12,27,3,3,6,0,2,2,2,2
1,0022000334,1610612759,Spurs,SAS,San Antonio,240.000000:00,111,66,43,23,11,0,13,30,4,2,6,1,4,3,1,5
0,0022000335,1610612756,Suns,PHX,Phoenix,240.000000:00,101,55,37,18,12,0,5,10,3,3,6,0,8,7,2,8
1,0022000335,1610612740,Pelicans,NOP,New Orleans,240.000000:00,123,54,28,26,18,1,13,33,1,2,3,2,3,3,2,5
0,0022000336,1610612738,Celtics,BOS,Boston,240.000000:00,111,35,25,10,16,0,4,9,2,3,5,3,3,6,2,6
1,0022000336,1610612758,Kings,SAC,Sacramento,240.000000:00,116,32,21,11,14,0,12,26,5,2,7,2,15,15,4,17
0,0022000337,1610612757,Trail Blazers,POR,Portland,240.000000:00,121,52,29,23,10,0,12,27,3,2,5,3,4,7,6,7
1,0022000337,1610612755,76ers,PHI,Philadelphia,240.000000:00,105,57,38,19,13,0,12,25,4,6,10,1,5,3,2,6
0,0022000338,1610612762,Jazz,UTA,Utah,240.000000:00,112,51,34,17,12,0,25,58,3,2,5,2,6,7,4,8
1,0022000338,1610612737,Hawks,ATL,Atlanta,240.000000:00,91,46,29,17,25,0,10,22,3,3,6,1,6,7,4,7
0,0022000339,1610612744,Warriors,GSW,Golden State,240.000000:00,147,61,28,33,13,0,10,26,2,1,3,1,8,8,2,9
1,0022000339,1610612742,Mavericks,DAL,Dallas,240.000000:00,116,52,27,25,12,0,7,20,2,1,3,1,1,1,1,2
0,0022000340,1610612745,Rockets,HOU,Houston,240.000000:00,115,52,32,20,10,0,8,20,1,3,4,1,15,6,3,16
1,0022000340,1610612763,Grizzlies,MEM,Memphis,240.000000:00,103,63,31,32,19,0,8,16,1,4,5,0,8,6,1,8
0,0022000341,1610612743,Nuggets,DEN,Denver,240.000000:00,93,41,27,14,11,1,5,10,5,2,7,1,2,3,2,3
1,0022000341,1610612747,Lakers,LAL,Los Angeles,240.000000:00,114,62,45,17,16,1,6,14,5,4,9,2,9,9,5,11
0,0022000342,1610612762,Jazz,UTA,Utah,240.000000:00,138,46,28,18,10,0,7,17,0,0,0,2,9,11,6,11
1,0022000342,1610612766,Hornets,CHA,Charlotte,240.000000:00,121,48,22,26,18,1,20,45,1,3,4,1,16,12,2,17
0,0022000343,1610612740,Pelicans,NOP,New Orleans,240.000000:00,114,70,45,25,12,2,4,9,1,2,3,0,11,10,5,11
1,0022000343,1610612754,Pacers,IND,Indiana,240.000000:00,113,53,36,17,17,1,17,42,1,5,6,0,3,3,3,3
0,0022000344,1610612741,Bulls,CHI,Chicago,240.000000:00,119,61,41,20,16,1,17,34,4,2,6,4,10,12,4,14
1,0022000344,1610612753,Magic,ORL,Orlando,240.000000:00,123,54,40,14,12,0,15,33,2,3,5,2,11,13,4,13
0,0022000345,1610612761,Raptors,TOR,Toronto,240.000000:00,123,46,23,23,22,0,7,17,3,4,7,0,8,6,2,8
1,0022000345,1610612751,Nets,BKN,Brooklyn,240.000000:00,117,62,40,22,13,0,6,13,4,2,6,3,5,8,4,8
0,0022000346,1610612749,Bucks,MIL,Milwaukee,240.000000:00,123,68,47,21,15,0,11,25,4,3,7,2,4,6,4,6
1,0022000346,1610612739,Cavaliers,CLE,Cleveland,240.000000:00,105,64,48,16,15,1,14,32,3,4,7,0,10,5,4,10
0,0022000347,1610612764,Wizards,WAS,Washington,240.000000:00,95,58,36,22,11,0,3,6,3,5,8,2,3,2,1,5
1,0022000347,1610612748,Heat,MIA,Miami,240.000000:00,122,51,30,21,16,2,8,18,4,1,5,1,10,10,1,11
0,0022000348,1610612750,Timberwolves,MIN,Minnesota,240.000000:00,106,60,35,25,14,0,14,31,1,6,7,1,8,7,4,9
1,0022000348,1610612760,Thunder,OKC,Oklahoma City,240.000000:00,103,72,40,32,15,0,6,14,3,5,8,2,8,7,2,10
0,0022000349,1610612765,Pistons,DET,Detroit,240.000000:00,92,42,26,16,13,1,15,36,7,6,13,5,11,15,6,16
1,0022000349,1610612756,Suns,PHX,Phoenix,240.000000:00,109,43,30,13,17,0,11,23,3,6,9,3,12,12,6,15
0,0022000350,1610612738,Celtics,BOS,Boston,240.000000:00,119,57,33,24,18,0,20,44,3,4,7,2,8,8,4,10
1,0022000350,1610612746,Clippers,LAC,LA,240.000000:00,115,43,28,15,8,0,11,25,2,1,3,2,4,5,2,6
0,0022000351,1610612757,Trail Blazers,POR,Portland,240.000000:00,99,44,27,17,17,0,11,27,3,8,11,5,8,12,10,13
1,0022000351,1610612752,Knicks,NYK,New York,240.000000:00,110,64,28,36,9,0,12,25,2,3,5,2,13,12,9,15
0,0022000352,1610612743,Nuggets,DEN,Denver,240.000000:00,114,55,29,26,10,1,6,15,3,3,6,6,5,8,4,11
1,0022000352,1610612758,Kings,SAC,Sacramento,240.000000:00,119,70,48,22,11,0,5,13,4,5,9,3,5,6,6,8
0,0022000353,1610612741,Bulls,CHI,Chicago,240.000000:00,118,66,47,19,17,0,17,39,6,6,12,1,11,10,2,12
1,0022000353,1610612753,Magic,ORL,Orlando,240.000000:00,92,62,39,23,12,0,14,30,7,3,10,4,4,8,6,8
0,0022000354,1610612751,Nets,BKN,Brooklyn,240.000000:00,108,57,44,13,14,1,11,25,2,6,8,1,6,4,1,7
1,0022000354,1610612755,76ers,PHI,Philadelphia,240.000000:00,124,54,27,27,25,1,7,15,3,3,6,1,6,3,2,7
0,0022000355,1610612763,Grizzlies,MEM,Memphis,240.000000:00,109,58,38,20,11,1,9,18,7,2,9,1,8,9,4,9
1,0022000355,1610612740,Pelicans,NOP,New Orleans,240.000000:00,118,62,34,28,13,1,11,26,4,3,7,1,6,7,1,7
0,0022000356,1610612761,Raptors,TOR,Toronto,240.000000:00,121,43,20,23,13,0,10,23,4,3,7,0,8,4,0,8
1,0022000356,1610612737,Hawks,ATL,Atlanta,240.000000:00,132,66,42,24,9,0,7,18,2,1,3,0,7,7,3,7
0,0022000357,1610612749,Bucks,MIL,Milwaukee,240.000000:00,124,45,29,16,21,0,10,24,5,4,9,1,11,10,4,12
1,0022000357,1610612739,Cavaliers,CLE,Cleveland,240.000000:00,99,41,27,14,13,0,10,20,4,2,6,2,16,14,7,18
0,0022000358,1610612759,Spurs,SAS,San Antonio,240.000000:00,111,72,47,25,14,1,9,19,4,2,6,0,1,0,0,1
1,0022000358,1610612745,Rockets,HOU,Houston,240.000000:00,106,58,43,15,10,0,9,20,9,2,11,1,11,7,3,12
0,0022000359,1610612750,Timberwolves,MIN,Minnesota,240.000000:00,118,64,40,24,21,0,16,36,5,5,10,0,2,2,1,2
1,0022000359,1610612760,Thunder,OKC,Oklahoma City,240.000000:00,120,62,34,28,18,0,6,14,2,4,6,1,5,5,2,6
0,0022000360,1610612744,Warriors,GSW,Golden State,240.000000:00,132,60,33,27,21,0,16,40,3,4,7,1,3,4,2,4
1,0022000360,1610612742,Mavericks,DAL,Dallas,240.000000:00,134,43,17,26,7,1,7,20,7,1,8,0,6,5,1,6
0,0022000361,1610612765,Pistons,DET,Detroit,290.000000:00,129,38,29,9,17,1,8,18,8,1,9,0,6,1,0,6
1,0022000361,1610612747,Lakers,LAL,Los Angeles,290.000000:00,135,51,25,26,22,1,7,15,3,7,10,2,8,8,2,10
0,0022000362,1610612757,Trail Blazers,POR,Portland,240.000000:00,101,51,24,27,12,1,8,17,2,1,3,1,2,2,1,3
1,0022000362,1610612766,Hornets,CHA,Charlotte,240.000000:00,109,57,33,24,12,1,8,22,3,2,5,1,4,5,2,5
0,0022000363,1610612762,Jazz,UTA,Utah,240.000000:00,103,68,47,21,12,1,7,16,4,3,7,0,11,10,3,11
1,0022000363,1610612754,Pacers,IND,Indiana,240.000000:00,95,65,37,28,15,0,14,32,4,2,6,2,8,10,4,10
0,0022000364,1610612748,Heat,MIA,Miami,240.000000:00,109,47,23,24,13,0,8,21,3,5,8,3,10,8,1,13
1,0022000364,1610612752,Knicks,NYK,New York,240.000000:00,103,44,23,21,12,0,4,8,3,5,8,2,9,8,4,11
0,0022000365,1610612738,Celtics,BOS,Boston,240.000000:00,91,50,31,19,11,1,5,13,4,5,9,3,15,15,4,18
1,0022000365,1610612756,Suns,PHX,Phoenix,240.000000:00,100,58,32,26,11,0,14,28,3,2,5,1,15,14,4,16
0,0022000366,1610612758,Kings,SAC,Sacramento,240.000000:00,113,63,43,20,9,1,9,19,5,5,10,2,12,10,4,14
1,0022000366,1610612746,Clippers,LAC,LA,240.000000:00,110,64,43,21,8,0,9,20,2,4,6,3,11,10,8,14
0,0022000367,1610612745,Rockets,HOU,Houston,240.000000:00,94,59,30,29,19,0,5,11,2,3,5,0,7,7,5,7
1,0022000367,1610612766,Hornets,CHA,Charlotte,240.000000:00,119,50,25,25,15,1,5,14,3,5,8,0,4,1,0,4
0,0022000368,1610612764,Wizards,WAS,Washington,240.000000:00,105,59,43,16,14,1,13,29,3,3,6,0,8,8,3,8
1,0022000368,1610612741,Bulls,CHI,Chicago,240.000000:00,101,58,37,21,12,0,14,30,2,3,5,0,5,5,1,5
0,0022000369,1610612761,Raptors,TOR,Toronto,240.000000:00,128,63,32,31,14,0,14,38,4,6,10,1,15,12,6,16
1,0022000369,1610612763,Grizzlies,MEM,Memphis,240.000000:00,113,45,23,22,10,2,2,4,6,2,8,4,11,10,6,15
0,0022000370,1610612750,Timberwolves,MIN,Minnesota,240.000000:00,122,33,21,12,20,1,17,40,3,7,10,5,7,10,5,12
1,0022000370,1610612742,Mavericks,DAL,Dallas,240.000000:00,127,42,23,19,11,2,16,32,3,4,7,1,9,9,2,10
0,0022000371,1610612744,Warriors,GSW,Golden State,240.000000:00,100,53,34,19,7,0,5,11,3,6,9,0,14,11,4,14
1,0022000371,1610612759,Spurs,SAS,San Antonio,240.000000:00,105,53,33,20,18,0,11,24,1,3,4,0,2,2,0,2
0,0022000372,1610612739,Cavaliers,CLE,Cleveland,240.000000:00,113,55,44,11,10,0,10,22,4,4,8,6,9,14,9,15
1,0022000372,1610612756,Suns,PHX,Phoenix,240.000000:00,119,46,33,13,14,1,14,31,3,2,5,4,14,12,7,18
0,0022000373,1610612749,Bucks,MIL,Milwaukee,240.000000:00,125,62,39,23,19,0,7,14,3,3,6,0,8,7,3,8
1,0022000373,1610612743,Nuggets,DEN,Denver,240.000000:00,112,49,26,23,5,0,8,18,7,1,8,4,11,10,4,15
0,0022000374,1610612760,Thunder,OKC,Oklahoma City,265.000000:00,112,57,34,23,12,0,12,27,8,2,10,0,3,3,1,3
1,0022000374,1610612747,Lakers,LAL,Los Angeles,265.000000:00,119,73,50,23,12,1,7,17,4,4,8,1,5,6,1,6
0,0022000375,1610612751,Nets,BKN,Brooklyn,240.000000:00,111,42,25,17,21,0,10,21,2,1,3,0,3,3,2,3
1,0022000375,1610612765,Pistons,DET,Detroit,240.000000:00,122,42,25,17,14,1,9,21,2,1,3,0,3,3,1,3
0,0022000376,1610612752,Knicks,NYK,New York,240.000000:00,96,53,27,26,18,0,6,13,4,4,8,0,4,2,1,4
1,0022000376,1610612748,Heat,MIA,Miami,240.000000:00,98,57,39,18,11,0,3,7,2,4,6,1,9,9,2,10
0,0022000377,1610612745,Rockets,HOU,Houston,240.000000:00,101,57,38,19,18,1,2,5,3,5,8,1,12,7,3,13
1,0022000377,1610612740,Pelicans,NOP,New Orleans,240.000000:00,130,54,27,27,16,1,6,14,3,5,8,1,4,4,1,5
0,0022000378,1610612744,Warriors,GSW,Golden State,240.000000:00,114,60,45,15,17,0,10,24,5,5,10,0,13,9,1,13
1,0022000378,1610612759,Spurs,SAS,San Antonio,240.000000:00,91,55,33,22,13,0,4,8,3,2,5,2,3,5,3,5
0,0022000379,1610612738,Celtics,BOS,Boston,240.000000:00,108,38,15,23,9,0,12,29,3,1,4,3,9,4,4,12
1,0022000379,1610612762,Jazz,UTA,Utah,240.000000:00,122,47,31,16,12,0,10,27,4,1,5,5,4,6,4,9
0,0022000380,1610612753,Magic,ORL,Orlando,240.000000:00,97,52,28,24,12,1,10,24,3,6,9,1,6,6,3,7
1,0022000380,1610612757,Trail Blazers,POR,Portland,240.000000:00,106,41,24,17,14,0,8,19,2,3,5,1,10,11,4,11
0,0022000381,1610612755,76ers,PHI,Philadelphia,240.000000:00,119,48,32,16,9,1,19,43,2,2,4,2,6,7,5,8
1,0022000381,1610612758,Kings,SAC,Sacramento,240.000000:00,111,46,38,8,14,1,11,23,2,4,6,0,6,4,2,6
0,0022000382,1610612761,Raptors,TOR,Toronto,240.000000:00,137,48,26,22,15,2,14,33,2,2,4,0,9,7,3,9
1,0022000382,1610612764,Wizards,WAS,Washington,240.000000:00,115,53,33,20,17,2,7,17,0,3,3,3,6,9,4,9
0,0022000383,1610612754,Pacers,IND,Indiana,240.000000:00,94,43,22,21,12,0,9,23,3,5,8,0,5,5,3,5
1,0022000383,1610612751,Nets,BKN,Brooklyn,240.000000:00,104,48,33,15,8,0,6,13,2,7,9,0,8,7,2,8
0,0022000384,1610612737,Hawks,ATL,Atlanta,240.000000:00,117,63,35,28,7,1,7,18,2,4,6,1,5,5,4,6
1,0022000384,1610612742,Mavericks,DAL,Dallas,240.000000:00,118,61,34,27,7,1,7,17,2,1,3,1,9,8,2,10
0,0022000385,1610612740,Pelicans,NOP,New Orleans,240.000000:00,116,50,21,29,23,1,8,18,3,1,4,1,7,7,0,8
1,0022000385,1610612741,Bulls,CHI,Chicago,240.000000:00,129,57,32,25,10,2,8,20,4,3,7,2,14,14,1,16
0,0022000386,1610612766,Hornets,CHA,Charlotte,240.000000:00,114,65,26,39,18,1,7,17,3,2,5,3,15,13,6,18
1,0022000386,1610612763,Grizzlies,MEM,Memphis,240.000000:00,130,59,39,20,15,0,6,14,4,2,6,5,13,13,7,18
0,0022000387,1610612746,Clippers,LAC,LA,240.000000:00,119,47,24,23,15,0,18,43,6,1,7,3,8,11,4,11
1,0022000387,1610612750,Timberwolves,MIN,Minnesota,240.000000:00,112,51,39,12,21,0,8,19,4,5,9,1,9,9,4,10
0,0022000388,1610612739,Cavaliers,CLE,Cleveland,240.000000:00,95,41,23,18,16,0,2,5,6,2,8,1,4,5,1,5
1,0022000388,1610612743,Nuggets,DEN,Denver,240.000000:00,133,51,32,19,20,0,5,11,2,2,4,1,7,6,4,8
0,0022000389,1610612749,Bucks,MIL,Milwaukee,240.000000:00,124,67,44,23,18,0,16,41,4,2,6,0,5,5,1,5
1,0022000389,1610612756,Suns,PHX,Phoenix,240.000000:00,125,55,33,22,13,1,19,42,2,3,5,1,11,12,4,12
0,0022000390,1610612760,Thunder,OKC,Oklahoma City,265.000000:00,113,58,32,26,14,0,12,24,0,4,4,0,5,5,2,5
1,0022000390,1610612747,Lakers,LAL,Los Angeles,265.000000:00,114,72,48,24,10,2,9,21,4,5,9,2,8,8,4,10
0,0022000391,1610612754,Pacers,IND,Indiana,240.000000:00,111,45,33,12,22,0,11,24,4,3,7,3,12,13,5,15
1,0022000391,1610612765,Pistons,DET,Detroit,240.000000:00,95,49,38,11,18,1,8,18,3,1,4,6,4,8,6,10
0,0022000392,1610612748,Heat,MIA,Miami,240.000000:00,101,50,18,32,17,2,14,36,1,3,4,4,11,11,6,15
1,0022000392,1610612745,Rockets,HOU,Houston,240.000000:00,94,43,20,23,9,0,5,13,3,4,7,2,10,11,7,12
0,0022000393,1610612753,Magic,ORL,Orlando,240.000000:00,105,48,19,29,16,1,11,29,3,4,7,2,4,6,3,6
1,0022000393,1610612744,Warriors,GSW,Golden State,240.000000:00,111,68,41,27,16,0,12,34,4,1,5,0,14,11,3,14
0,0022000394,1610612755,76ers,PHI,Philadelphia,240.000000:00,114,55,32,23,17,0,10,20,5,3,8,4,12,15,8,16
1,0022000394,1610612757,Trail Blazers,POR,Portland,240.000000:00,118,44,31,13,13,0,14,37,5,4,9,4,4,8,7,8
0,0022000395,1610612750,Timberwolves,MIN,Minnesota,240.000000:00,114,54,31,23,15,1,12,27,1,5,6,1,4,4,4,5
1,0022000395,1610612766,Hornets,CHA,Charlotte,240.000000:00,120,59,36,23,13,0,16,36,3,3,6,2,10,11,3,12
0,0022000396,1610612752,Knicks,NYK,New York,240.000000:00,109,51,37,14,17,0,13,26,5,2,7,1,14,11,9,15
1,0022000396,1610612764,Wizards,WAS,Washington,240.000000:00,91,61,43,18,13,0,6,14,3,1,4,1,3,4,2,4
0,0022000397,1610612759,Spurs,SAS,San Antonio,240.000000:00,125,66,44,22,12,0,10,24,2,3,5,1,5,4,1,6
1,0022000397,1610612737,Hawks,ATL,Atlanta,240.000000:00,114,59,38,21,16,1,3,6,2,2,4,1,9,8,5,10
0,0022000398,1610612761,Raptors,TOR,Toronto,240.000000:00,106,65,35,30,14,1,5,11,1,7,8,2,9,4,2,11
1,0022000398,1610612738,Celtics,BOS,Boston,240.000000:00,120,49,29,20,12,1,7,18,2,3,5,6,8,11,5,14
0,0022000399,1610612740,Pelicans,NOP,New Orleans,240.000000:00,130,35,22,13,10,0,10,22,3,3,6,4,4,7,3,8
1,0022000399,1610612742,Mavericks,DAL,Dallas,240.000000:00,143,33,19,14,9,1,12,28,3,1,4,0,17,15,5,17
0,0022000400,1610612746,Clippers,LAC,LA,240.000000:00,125,60,37,23,16,0,19,41,0,1,1,0,17,7,4,17
1,0022000400,1610612741,Bulls,CHI,Chicago,240.000000:00,106,72,45,27,8,1,13,31,0,4,4,4,11,11,5,15
0,0022000401,1610612760,Thunder,OKC,Oklahoma City,240.000000:00,95,54,26,28,10,0,2,4,6,8,14,0,6,6,3,6
1,0022000401,1610612743,Nuggets,DEN,Denver,240.000000:00,97,59,35,24,13,2,10,25,3,3,6,1,2,2,1,3
0,0022000402,1610612749,Bucks,MIL,Milwaukee,240.000000:00,115,57,30,27,16,0,7,17,0,3,3,1,5,6,4,6
1,0022000402,1610612762,Jazz,UTA,Utah,240.000000:00,129,56,34,22,7,0,10,24,3,2,5,3,5,6,3,8
0,0022000403,1610612763,Grizzlies,MEM,Memphis,240.000000:00,105,55,33,22,18,1,11,27,1,4,5,2,7,6,3,9
1,0022000403,1610612747,Lakers,LAL,Los Angeles,240.000000:00,115,47,31,16,12,3,3,7,3,3,6,3,8,9,5,11
0,0022000404,1610612739,Cavaliers,CLE,Cleveland,240.000000:00,110,49,30,19,13,0,8,17,4,4,8,4,11,12,5,15
1,0022000404,1610612757,Trail Blazers,POR,Portland,240.000000:00,129,41,24,17,19,0,15,35,2,3,5,6,7,7,5,13
0,0022000405,1610612753,Magic,ORL,Orlando,240.000000:00,123,39,23,16,10,1,12,28,2,3,5,2,5,5,3,7
1,0022000405,1610612758,Kings,SAC,Sacramento,240.000000:00,112,52,37,15,19,1,9,20,3,3,6,1,10,9,4,11
0,0022000406,1610612755,76ers,PHI,Philadelphia,240.000000:00,111,34,21,13,18,0,7,14,0,1,1,1,3,3,2,4
1,0022000406,1610612756,Suns,PHX,Phoenix,240.000000:00,120,45,34,11,10,0,16,33,6,5,11,1,3,3,2,4
0,0022000407,1610612754,Pacers,IND,Indiana,240.000000:00,125,61,34,27,12,1,10,24,4,4,8,1,16,11,4,17
1,0022000407,1610612737,Hawks,ATL,Atlanta,240.000000:00,113,66,44,22,11,0,3,6,3,3,6,1,13,7,0,14
0,0022000408,1610612745,Rockets,HOU,Houston,240.000000:00,99,40,28,12,11,1,9,23,3,3,6,3,10,13,7,13
1,0022000408,1610612752,Knicks,NYK,New York,240.000000:00,121,54,28,26,15,0,14,31,2,2,4,1,6,7,3,7
0,0022000409,1610612751,Nets,BKN,Brooklyn,240.000000:00,134,55,34,21,18,0,11,27,2,3,5,1,6,5,3,7
1,0022000409,1610612744,Warriors,GSW,Golden State,240.000000:00,117,65,34,31,11,0,10,21,2,4,6,2,11,10,2,13
0,0022000410,1610612748,Heat,MIA,Miami,240.000000:00,94,44,22,22,16,0,14,33,2,2,4,1,14,12,1,15
1,0022000410,1610612762,Jazz,UTA,Utah,240.000000:00,112,39,25,14,11,0,6,14,4,7,11,0,12,12,4,12
0,0022000411,1610612757,Trail Blazers,POR,Portland,240.000000:00,121,39,18,21,11,1,10,25,3,2,5,2,0,2,2,2
1,0022000411,1610612742,Mavericks,DAL,Dallas,240.000000:00,118,56,30,26,12,1,13,30,5,3,8,0,7,7,3,7
0,0022000412,1610612765,Pistons,DET,Detroit,240.000000:00,108,52,36,16,12,2,11,25,3,2,5,0,6,5,1,6
1,0022000412,1610612738,Celtics,BOS,Boston,240.000000:00,102,59,28,31,15,1,10,20,3,3,6,2,7,7,3,9
0,0022000413,1610612750,Timberwolves,MIN,Minnesota,240.000000:00,116,61,43,18,14,0,8,17,3,4,7,0,4,3,3,4
1,0022000413,1610612761,Raptors,TOR,Toronto,240.000000:00,112,50,24,26,26,0,8,19,7,4,11,0,3,3,1,3
0,0022000414,1610612759,Spurs,SAS,San Antonio,240.000000:00,122,52,30,22,20,1,8,17,3,3,6,0,4,4,0,4
1,0022000414,1610612766,Hornets,CHA,Charlotte,240.000000:00,110,58,40,18,13,1,12,27,5,3,8,1,6,7,3,7
0,0022000415,1610612749,Bucks,MIL,Milwaukee,240.000000:00,109,63,39,24,16,0,17,39,5,3,8,3,5,5,3,8
1,0022000415,1610612760,Thunder,OKC,Oklahoma City,240.000000:00,114,45,24,21,14,0,11,25,6,4,10,2,15,13,2,17
0,0022000416,1610612747,Lakers,LAL,Los Angeles,240.000000:00,105,51,21,30,6,1,4,10,1,5,6,4,10,7,4,14
1,0022000416,1610612743,Nuggets,DEN,Denver,240.000000:00,122,45,30,15,22,0,8,20,1,5,6,1,14,9,2,15
0,0022000417,1610612753,Magic,ORL,Orlando,240.000000:00,90,60,32,28,12,0,9,21,4,2,6,1,7,8,6,8
1,0022000417,1610612756,Suns,PHX,Phoenix,240.000000:00,109,71,48,23,12,0,8,18,4,1,5,1,13,8,2,14
0,0022000418,1610612763,Grizzlies,MEM,Memphis,240.000000:00,124,54,27,27,13,0,11,23,5,6,11,6,7,8,4,13
1,0022000418,1610612758,Kings,SAC,Sacramento,240.000000:00,110,55,46,9,10,0,9,21,5,7,12,0,9,6,3,9
0,0022000419,1610612739,Cavaliers,CLE,Cleveland,240.000000:00,111,46,34,12,9,0,12,26,6,0,6,1,7,5,3,8
1,0022000419,1610612746,Clippers,LAC,LA,240.000000:00,128,37,25,12,19,1,9,20,3,3,6,4,8,7,4,12
0,0022000420,1610612741,Bulls,CHI,Chicago,265.000000:00,120,45,30,15,13,1,10,22,5,5,10,0,13,9,6,13
1,0022000420,1610612754,Pacers,IND,Indiana,265.000000:00,112,76,54,22,21,0,11,25,5,4,9,0,6,5,1,6
0,0022000421,1610612745,Rockets,HOU,Houston,240.000000:00,119,41,30,11,13,0,7,14,4,3,7,1,6,6,3,7
1,0022000421,1610612764,Wizards,WAS,Washington,240.000000:00,131,59,36,23,13,0,9,21,2,7,9,2,5,4,2,7
0,0022000422,1610612737,Hawks,ATL,Atlanta,240.000000:00,112,48,29,19,13,0,8,18,3,3,6,0,8,8,0,8
1,0022000422,1610612752,Knicks,NYK,New York,240.000000:00,123,50,29,21,11,0,7,17,5,6,11,3,9,8,2,12
0,0022000423,1610612755,76ers,PHI,Philadelphia,240.000000:00,123,38,21,17,16,0,13,31,3,2,5,4,3,7,5,7
1,0022000423,1610612762,Jazz,UTA,Utah,240.000000:00,134,44,30,14,20,0,21,50,1,1,2,1,6,7,1,7
0,0022000424,1610612739,Cavaliers,CLE,Cleveland,240.000000:00,98,42,24,18,16,0,11,23,4,2,6,4,2,6,4,6
1,0022000424,1610612744,Warriors,GSW,Golden State,240.000000:00,129,46,32,14,19,1,15,40,1,3,4,1,13,9,4,14
0,0022000425,1610612748,Heat,MIA,Miami,240.000000:00,118,51,29,22,14,1,11,27,2,2,4,2,14,12,8,16
1,0022000425,1610612746,Clippers,LAC,LA,240.000000:00,125,47,27,20,7,0,6,12,1,3,4,3,9,10,6,12
0,0022000426,1610612751,Nets,BKN,Brooklyn,240.000000:00,136,56,38,18,9,1,18,47,1,2,3,3,6,8,6,9
1,0022000426,1610612758,Kings,SAC,Sacramento,240.000000:00,125,55,22,33,12,0,12,28,1,0,1,3,6,7,3,9
0,0022000427,1610612743,Nuggets,DEN,Denver,240.000000:00,99,43,17,26,24,0,8,19,3,5,8,2,7,9,3,9
1,0022000427,1610612738,Celtics,BOS,Boston,240.000000:00,112,47,24,23,15,0,6,17,2,3,5,2,6,8,4,8
0,0022000428,1610612759,Spurs,SAS,San Antonio,240.000000:00,109,52,37,15,13,0,18,43,3,0,3,1,11,8,4,12
1,0022000428,1610612765,Pistons,DET,Detroit,240.000000:00,99,52,35,17,17,0,8,16,3,8,11,0,8,7,4,8
0,0022000429,1610612740,Pelicans,NOP,New Orleans,240.000000:00,144,59,39,20,12,1,8,16,2,7,9,5,17,20,12,22
1,0022000429,1610612763,Grizzlies,MEM,Memphis,240.000000:00,113,37,21,16,18,0,8,18,1,2,3,3,8,9,3,11
0,0022000430,1610612761,Raptors,TOR,Toronto,240.000000:00,124,58,33,25,13,1,10,23,3,1,4,0,9,7,3,9
1,0022000430,1610612749,Bucks,MIL,Milwaukee,240.000000:00,113,60,34,26,12,1,5,14,3,5,8,0,3,2,2,3
0,0022000431,1610612747,Lakers,LAL,Los Angeles,240.000000:00,112,62,38,24,11,3,12,28,1,6,7,1,5,6,4,6
1,0022000431,1610612750,Timberwolves,MIN,Minnesota,240.000000:00,104,49,37,12,18,0,11,27,2,5,7,1,5,4,2,6
0,0022000432,1610612757,Trail Blazers,POR,Portland,240.000000:00,115,44,27,17,12,0,15,38,2,5,7,3,5,8,4,8
1,0022000432,1610612760,Thunder,OKC,Oklahoma City,240.000000:00,104,64,33,31,11,1,3,7,2,3,5,0,7,7,6,7
0,0022000433,1610612751,Nets,BKN,Brooklyn,240.000000:00,128,51,34,17,11,0,10,23,2,3,5,3,11,14,7,14
1,0022000433,1610612756,Suns,PHX,Phoenix,240.000000:00,124,47,23,24,11,1,14,31,2,3,5,0,4,3,2,4
0,0022000434,1610612741,Bulls,CHI,Chicago,240.000000:00,120,61,36,25,16,0,9,24,3,1,4,6,3,9,7,9
1,0022000434,1610612766,Hornets,CHA,Charlotte,240.000000:00,99,57,30,27,21,0,8,20,5,3,8,1,4,5,4,5
0,0022000435,1610612759,Spurs,SAS,San Antonio,240.000000:00,116,53,31,22,14,0,12,25,2,3,5,1,5,6,3,6
1,0022000435,1610612739,Cavaliers,CLE,Cleveland,240.000000:00,110,55,42,13,18,0,12,25,3,4,7,0,2,1,1,2
0,0022000436,1610612752,Knicks,NYK,New York,240.000000:00,89,59,39,20,8,0,13,30,3,2,5,1,12,11,5,13
1,0022000436,1610612753,Magic,ORL,Orlando,240.000000:00,107,56,43,13,11,0,15,38,4,1,5,2,7,8,3,9
0,0022000437,1610612743,Nuggets,DEN,Denver,240.000000:00,128,55,31,24,15,3,15,33,3,5,8,3,9,5,4,12
1,0022000437,1610612764,Wizards,WAS,Washington,240.000000:00,130,57,32,25,21,1,6,15,4,3,7,2,13,9,3,15
0,0022000438,1610612737,Hawks,ATL,Atlanta,240.000000:00,122,53,34,19,20,0,9,21,1,4,5,4,12,10,8,16
1,0022000438,1610612738,Celtics,BOS,Boston,240.000000:00,114,42,26,16,12,0,11,25,5,5,10,1,11,7,5,12
0,0022000439,1610612745,Rockets,HOU,Houston,240.000000:00,113,50,34,16,22,0,5,10,4,3,7,4,13,10,2,17
1,0022000439,1610612755,76ers,PHI,Philadelphia,240.000000:00,118,56,26,30,20,2,13,30,3,5,8,4,17,11,3,21
0,0022000440,1610612754,Pacers,IND,Indiana,265.000000:00,134,55,34,21,22,0,17,39,2,1,3,5,11,12,4,16
1,0022000440,1610612750,Timberwolves,MIN,Minnesota,265.000000:00,128,64,47,17,16,0,2,6,4,6,10,1,13,6,3,14
0,0022000441,1610612757,Trail Blazers,POR,Portland,240.000000:00,126,36,21,15,13,1,13,31,0,2,2,1,8,6,4,9
1,0022000441,1610612740,Pelicans,NOP,New Orleans,240.000000:00,124,62,35,27,8,0,12,26,2,1,3,7,9,16,11,16
0,0022000442,1610612765,Pistons,DET,Detroit,240.000000:00,117,49,23,26,4,0,11,26,2,0,2,1,4,5,2,5
1,0022000442,1610612742,Mavericks,DAL,Dallas,240.000000:00,127,51,31,20,13,2,18,44,4,3,7,0,5,1,0,5
0,0022000443,1610612748,Heat,MIA,Miami,265.000000:00,112,67,25,42,11,1,13,30,1,3,4,1,4,5,2,5
1,0022000443,1610612744,Warriors,GSW,Golden State,265.000000:00,120,63,37,26,17,0,10,21,6,3,9,0,8,8,3,8
0,0022000444,1610612762,Jazz,UTA,Utah,240.000000:00,114,67,48,19,12,0,15,37,2,5,7,1,6,6,6,7
1,0022000444,1610612746,Clippers,LAC,LA,240.000000:00,96,54,30,24,9,1,8,16,1,2,3,1,6,3,1,7
0,0022000445,1610612761,Raptors,TOR,Toronto,240.000000:00,110,52,29,23,23,0,10,26,0,2,2,2,17,17,7,19
1,0022000445,1610612749,Bucks,MIL,Milwaukee,240.000000:00,96,46,26,20,19,0,2,5,3,0,3,4,9,13,7,13
0,0022000446,1610612751,Nets,BKN,Brooklyn,240.000000:00,109,50,32,18,20,0,15,37,1,4,5,1,8,8,4,9
1,0022000446,1610612747,Lakers,LAL,Los Angeles,240.000000:00,98,52,26,26,17,1,4,9,6,2,8,2,9,10,6,11
0,0022000447,1610612748,Heat,MIA,Miami,240.000000:00,118,48,25,23,13,0,18,45,4,0,4,4,7,10,5,11
1,0022000447,1610612758,Kings,SAC,Sacramento,240.000000:00,110,42,26,16,14,0,8,21,4,3,7,1,4,4,1,5
0,0022000448,1610612743,Nuggets,DEN,Denver,240.000000:00,117,46,26,20,16,0,6,14,1,6,7,3,5,7,6,8
1,0022000448,1610612766,Hornets,CHA,Charlotte,240.000000:00,112,50,34,16,14,2,5,13,6,1,7,0,8,5,0,8
0,0022000449,1610612744,Warriors,GSW,Golden State,240.000000:00,120,42,25,17,18,1,17,40,1,5,6,2,5,4,2,7
1,0022000449,1610612753,Magic,ORL,Orlando,240.000000:00,124,49,30,19,16,1,12,29,3,4,7,1,1,2,1,2
0,0022000450,1610612741,Bulls,CHI,Chicago,240.000000:00,105,61,43,18,14,0,9,19,1,4,5,0,9,7,1,9
1,0022000450,1610612755,76ers,PHI,Philadelphia,240.000000:00,112,59,38,21,11,0,6,12,2,2,4,9,7,11,8,16
0,0022000451,1610612737,Hawks,ATL,Atlanta,240.000000:00,109,47,27,20,23,0,9,20,5,7,12,4,7,10,7,11
1,0022000451,1610612738,Celtics,BOS,Boston,240.000000:00,121,58,36,22,14,2,15,39,7,2,9,2,18,13,6,20
0,0022000452,1610612765,Pistons,DET,Detroit,240.000000:00,95,42,32,10,11,0,8,17,4,5,9,3,4,5,5,7
1,0022000452,1610612763,Grizzlies,MEM,Memphis,240.000000:00,109,55,26,29,21,1,14,30,4,0,4,6,10,15,10,16
0,0022000453,1610612760,Thunder,OKC,Oklahoma City,240.000000:00,85,58,32,26,12,1,4,9,3,2,5,1,9,7,4,10
1,0022000453,1610612749,Bucks,MIL,Milwaukee,240.000000:00,98,62,29,33,13,1,7,16,3,5,8,0,2,2,1,2
0,0022000454,1610612761,Raptors,TOR,Toronto,240.000000:00,86,59,32,27,14,0,7,17,3,1,4,4,3,7,6,7
1,0022000454,1610612750,Timberwolves,MIN,Minnesota,240.000000:00,81,61,39,22,13,0,5,12,1,4,5,1,2,2,2,3
0,0022000455,1610612756,Suns,PHX,Phoenix,240.000000:00,132,48,28,20,17,0,8,18,2,4,6,1,12,9,3,13
1,0022000455,1610612740,Pelicans,NOP,New Orleans,240.000000:00,114,67,30,37,11,0,8,18,3,0,3,1,14,10,5,15
0,0022000456,1610612742,Mavericks,DAL,Dallas,240.000000:00,93,63,30,33,6,1,5,11,3,3,6,2,11,8,6,13
1,0022000456,1610612745,Rockets,HOU,Houston,240.000000:00,102,49,29,20,14,0,5,12,2,4,6,4,5,8,6,9
0,0022000457,1610612762,Jazz,UTA,Utah,240.000000:00,112,55,42,13,10,0,16,39,0,5,5,1,6,4,3,7
1,0022000457,1610612746,Clippers,LAC,LA,240.000000:00,116,48,32,16,8,0,12,25,5,2,7,0,3,2,1,3
0,0022000458,1610612759,Spurs,SAS,San Antonio,240.000000:00,98,43,32,11,8,0,9,19,1,0,1,1,11,10,3,12
1,0022000458,1610612752,Knicks,NYK,New York,240.000000:00,102,57,44,13,9,0,8,19,4,3,7,1,8,6,3,9
0,0022000459,1610612744,Warriors,GSW,Golden State,240.000000:00,100,55,26,29,18,3,5,13,5,4,9,1,4,2,1,5
1,0022000459,1610612766,Hornets,CHA,Charlotte,240.000000:00,102,57,29,28,13,0,9,22,3,2,5,1,2,2,1,3
0,0022000460,1610612758,Kings,SAC,Sacramento,240.000000:00,114,46,30,16,16,1,14,30,7,3,10,1,8,9,5,9
1,0022000460,1610612741,Bulls,CHI,Chicago,240.000000:00,122,56,41,15,10,0,12,27,0,2,2,0,12,12,7,12
0,0022000461,1610612754,Pacers,IND,Indiana,240.000000:00,132,51,32,19,13,0,8,20,4,5,9,1,3,2,1,4
1,0022000461,1610612745,Rockets,HOU,Houston,240.000000:00,124,38,24,14,15,0,11,23,5,5,10,2,6,7,5,8
0,0022000462,1610612756,Suns,PHX,Phoenix,240.000000:00,128,68,45,23,9,0,12,27,3,1,4,1,6,7,2,7
1,0022000462,1610612763,Grizzlies,MEM,Memphis,240.000000:00,97,59,26,33,14,0,8,16,4,1,5,0,4,4,1,4
0,0022000463,1610612748,Heat,MIA,Miami,240.000000:00,96,47,23,24,12,0,10,22,2,3,5,2,16,10,7,18
1,0022000463,1610612747,Lakers,LAL,Los Angeles,240.000000:00,94,43,28,15,9,0,6,14,1,2,3,2,14,12,9,16
0,0022000464,1610612764,Wizards,WAS,Washington,240.000000:00,118,69,31,38,15,1,17,38,7,4,11,3,5,8,4,8
1,0022000464,1610612757,Trail Blazers,POR,Portland,240.000000:00,111,39,27,12,19,0,8,22,3,4,7,4,5,5,5,9
0,0022000465,1610612738,Celtics,BOS,Boston,265.000000:00,115,62,39,23,17,2,11,24,1,1,2,2,10,10,4,12
1,0022000465,1610612740,Pelicans,NOP,New Orleans,265.000000:00,120,71,45,26,12,1,9,19,6,1,7,1,11,11,4,12
0,0022000466,1610612760,Thunder,OKC,Oklahoma City,240.000000:00,117,49,25,24,16,0,13,31,3,3,6,0,13,9,3,13
1,0022000466,1610612739,Cavaliers,CLE,Cleveland,240.000000:00,101,51,32,19,11,0,12,25,4,3,7,1,10,10,4,11
0,0022000467,1610612765,Pistons,DET,Detroit,240.000000:00,96,51,33,18,17,1,12,29,3,5,8,2,5,7,5,7
1,0022000467,1610612753,Magic,ORL,Orlando,240.000000:00,105,60,33,27,11,2,11,26,3,3,6,1,12,10,3,13
0,0022000468,1610612755,76ers,PHI,Philadelphia,240.000000:00,103,41,27,14,9,0,2,5,2,3,5,3,3,6,5,6
1,0022000468,1610612761,Raptors,TOR,Toronto,240.000000:00,110,48,21,27,6,0,7,20,1,3,4,0,1,0,0,1
0,0022000469,1610612750,Timberwolves,MIN,Minnesota,240.000000:00,99,48,38,10,14,0,8,21,1,2,3,2,9,11,8,11
1,0022000469,1610612752,Knicks,NYK,New York,240.000000:00,103,48,26,22,21,0,10,21,3,3,6,5,3,8,5,8
0,0022000470,1610612743,Nuggets,DEN,Denver,240.000000:00,115,44,22,22,15,0,11,25,1,3,4,2,15,9,6,17
1,0022000470,1610612737,Hawks,ATL,Atlanta,240.000000:00,123,47,23,24,11,0,4,10,5,4,9,1,9,6,1,10
0,0022000471,1610612758,Kings,SAC,Sacramento,240.000000:00,115,60,36,24,12,4,11,23,2,4,6,2,3,3,2,5
1,0022000471,1610612749,Bucks,MIL,Milwaukee,240.000000:00,128,74,46,28,12,2,15,34,2,3,5,2,4,5,3,6
0,0022000472,1610612751,Nets,BKN,Brooklyn,240.000000:00,112,59,37,22,12,0,14,32,3,5,8,1,8,5,4,9
1,0022000472,1610612746,Clippers,LAC,LA,240.000000:00,108,63,33,30,5,0,8,19,4,3,7,1,6,5,2,7
0,0022000473,1610612759,Spurs,SAS,San Antonio,240.000000:00,109,74,49,25,14,1,9,20,2,0,2,1,15,14,3,16
1,0022000473,1610612754,Pacers,IND,Indiana,240.000000:00,94,59,38,21,14,1,8,17,4,2,6,0,10,8,3,10
0,0022000474,1610612741,Bulls,CHI,Chicago,240.000000:00,120,63,37,26,19,1,9,20,5,4,9,4,10,10,5,14
1,0022000474,1610612745,Rockets,HOU,Houston,240.000000:00,100,46,30,16,22,0,9,21,4,1,5,4,6,10,8,10
0,0022000475,1610612748,Heat,MIA,Miami,240.000000:00,108,43,24,19,15,2,10,26,3,3,6,2,6,8,5,8
1,0022000475,1610612760,Thunder,OKC,Oklahoma City,240.000000:00,94,44,24,20,11,1,5,12,3,2,5,1,8,9,5,9
0,0022000476,1610612763,Grizzlies,MEM,Memphis,240.000000:00,92,56,27,29,14,1,16,32,1,0,1,0,16,13,7,16
1,0022000476,1610612742,Mavericks,DAL,Dallas,240.000000:00,102,59,40,19,10,0,9,22,1,4,5,1,21,18,4,22
0,0022000477,1610612757,Trail Blazers,POR,Portland,240.000000:00,100,52,27,25,15,0,12,26,3,2,5,4,12,14,7,16
1,0022000477,1610612756,Suns,PHX,Phoenix,240.000000:00,132,62,27,35,12,2,15,36,3,0,3,4,12,12,5,16
0,0022000478,1610612766,Hornets,CHA,Charlotte,240.000000:00,110,55,18,37,13,1,13,28,2,6,8,2,10,6,3,12
1,0022000478,1610612762,Jazz,UTA,Utah,240.000000:00,132,67,35,32,12,1,5,13,3,4,7,3,5,6,2,8
0,0022000479,1610612764,Wizards,WAS,Washington,265.000000:00,127,57,32,25,16,3,10,20,6,3,9,1,11,11,4,12
1,0022000479,1610612747,Lakers,LAL,Los Angeles,265.000000:00,124,44,35,9,18,1,14,33,7,1,8,1,10,9,2,11
0,0022000480,1610612737,Hawks,ATL,Atlanta,240.000000:00,111,40,24,16,31,2,9,20,1,3,4,2,8,9,6,10
1,0022000480,1610612739,Cavaliers,CLE,Cleveland,240.000000:00,112,45,26,19,15,0,12,26,3,4,7,0,6,6,3,6
0,0022000481,1610612765,Pistons,DET,Detroit,240.000000:00,105,52,32,20,15,0,7,15,5,2,7,0,2,2,0,2
1,0022000481,1610612753,Magic,ORL,Orlando,240.000000:00,93,50,28,22,14,1,6,16,3,7,10,1,5,4,3,6
0,0022000482,1610612758,Kings,SAC,Sacramento,240.000000:00,118,58,27,31,17,0,10,27,2,0,2,1,8,9,2,9
1,0022000482,1610612751,Nets,BKN,Brooklyn,240.000000:00,127,49,30,19,14,0,10,27,6,3,9,0,6,5,0,6
0,0022000483,1610612744,Warriors,GSW,Golden State,240.000000:00,114,68,54,14,12,2,12,28,4,5,9,0,12,9,2,12
1,0022000483,1610612752,Knicks,NYK,New York,240.000000:00,106,57,31,26,12,1,9,19,4,4,8,0,9,8,2,9
0,0022000484,1610612755,76ers,PHI,Philadelphia,240.000000:00,109,55,30,25,10,1,6,13,6,3,9,3,12,13,9,15
1,0022000484,1610612761,Raptors,TOR,Toronto,240.000000:00,102,52,27,25,16,0,6,13,4,7,11,2,13,9,6,15
0,0022000485,1610612738,Celtics,BOS,Boston,240.000000:00,107,57,29,28,8,1,12,28,3,4,7,3,14,13,6,17
1,0022000485,1610612742,Mavericks,DAL,Dallas,240.000000:00,110,50,26,24,9,1,13,31,2,2,4,0,12,3,2,12
0,0022000486,1610612750,Timberwolves,MIN,Minnesota,240.000000:00,112,55,26,29,17,0,10,24,1,4,5,2,4,4,2,6
1,0022000486,1610612749,Bucks,MIL,Milwaukee,240.000000:00,139,58,31,27,12,0,11,26,6,3,9,0,8,5,1,8
0,0022000487,1610612757,Trail Blazers,POR,Portland,240.000000:00,106,52,31,21,5,0,4,10,0,2,2,1,7,7,3,8
1,0022000487,1610612743,Nuggets,DEN,Denver,240.000000:00,111,47,24,23,10,0,3,8,2,2,4,1,2,2,1,3
0,0022000488,1610612764,Wizards,WAS,Washington,240.000000:00,116,50,28,22,8,0,15,34,3,1,4,0,7,7,4,7
1,0022000488,1610612746,Clippers,LAC,LA,240.000000:00,135,42,31,11,12,0,14,35,3,0,3,1,6,7,5,7
0,0022000489,1610612744,Warriors,GSW,Golden State,240.000000:00,111,51,32,19,22,1,6,12,4,3,7,1,17,13,7,18
1,0022000489,1610612754,Pacers,IND,Indiana,240.000000:00,107,47,27,20,21,2,7,15,9,4,13,2,9,7,6,11
0,0022000490,1610612738,Celtics,BOS,Boston,240.000000:00,112,51,23,28,16,0,12,25,3,6,9,1,8,8,2,9
1,0022000490,1610612737,Hawks,ATL,Atlanta,240.000000:00,127,47,30,17,11,0,6,15,6,6,12,2,9,10,6,11
0,0022000491,1610612745,Rockets,HOU,Houston,240.000000:00,96,46,29,17,16,1,7,14,5,4,9,0,12,12,1,12
1,0022000491,1610612739,Cavaliers,CLE,Cleveland,240.000000:00,112,59,40,19,13,0,4,9,2,3,5,0,6,6,1,6
0,0022000492,1610612761,Raptors,TOR,Toronto,240.000000:00,108,41,19,22,19,0,7,18,2,2,4,2,8,10,5,10
1,0022000492,1610612748,Heat,MIA,Miami,240.000000:00,116,36,14,22,17,2,8,20,2,6,8,1,7,8,3,8
0,0022000493,1610612750,Timberwolves,MIN,Minnesota,265.000000:00,126,54,43,11,13,0,17,38,2,5,7,2,8,6,4,10
1,0022000493,1610612741,Bulls,CHI,Chicago,265.000000:00,133,62,40,22,12,3,23,49,1,5,6,1,11,5,3,12
0,0022000494,1610612765,Pistons,DET,Detroit,240.000000:00,118,54,37,17,17,0,19,48,1,3,4,1,11,11,7,12
1,0022000494,1610612740,Pelicans,NOP,New Orleans,240.000000:00,128,57,37,20,14,0,12,27,5,3,8,7,6,12,4,13
0,0022000495,1610612759,Spurs,SAS,San Antonio,240.000000:00,99,70,37,33,10,0,19,39,0,4,4,2,6,7,2,8
1,0022000495,1610612760,Thunder,OKC,Oklahoma City,240.000000:00,102,62,46,16,11,0,6,17,2,1,3,0,19,10,7,19
0,0022000496,1610612766,Hornets,CHA,Charlotte,240.000000:00,124,52,29,23,11,1,6,15,1,2,3,2,6,7,6,8
1,0022000496,1610612756,Suns,PHX,Phoenix,240.000000:00,121,65,36,29,8,0,6,13,3,3,6,2,3,4,3,5
0,0022000497,1610612747,Lakers,LAL,Los Angeles,240.000000:00,89,50,19,31,15,0,5,13,3,2,5,2,5,6,3,7
1,0022000497,1610612762,Jazz,UTA,Utah,240.000000:00,114,58,35,23,11,0,7,20,4,4,8,1,6,5,1,7
0,0022000498,1610612742,Mavericks,DAL,Dallas,240.000000:00,97,56,39,17,8,0,13,29,3,2,5,2,11,8,4,13
1,0022000498,1610612755,76ers,PHI,Philadelphia,240.000000:00,111,36,20,16,24,0,8,16,3,5,8,6,8,11,9,14
0,0022000499,1610612753,Magic,ORL,Orlando,240.000000:00,92,49,23,26,12,0,8,19,3,3,6,1,9,7,2,10
1,0022000499,1610612751,Nets,BKN,Brooklyn,240.000000:00,129,48,30,18,16,1,6,15,3,1,4,2,5,5,3,7
0,0022000500,1610612758,Kings,SAC,Sacramento,240.000000:00,121,52,32,20,18,0,7,15,4,4,8,1,7,7,4,8
1,0022000500,1610612752,Knicks,NYK,New York,240.000000:00,140,44,24,20,16,3,17,38,3,3,6,1,6,7,2,7
0,0022000501,1610612746,Clippers,LAC,LA,240.000000:00,94,50,43,7,13,0,10,21,5,1,6,4,9,10,4,13
1,0022000501,1610612763,Grizzlies,MEM,Memphis,240.000000:00,122,50,32,18,18,0,14,31,1,1,2,1,15,13,2,16
0,0022000502,1610612764,Wizards,WAS,Washington,240.000000:00,112,48,24,24,17,2,4,8,3,2,5,0,8,8,0,8
1,0022000502,1610612743,Nuggets,DEN,Denver,240.000000:00,110,42,31,11,20,1,10,24,2,2,4,1,7,6,2,8
0,0022000503,1610612740,Pelicans,NOP,New Orleans,240.000000:00,125,56,37,19,8,0,10,22,4,3,7,1,3,3,3,4
1,0022000503,1610612749,Bucks,MIL,Milwaukee,240.000000:00,129,64,37,27,11,1,13,31,3,4,7,2,4,5,4,6
0,0022000504,1610612758,Kings,SAC,Sacramento,240.000000:00,110,39,22,17,12,0,11,26,4,2,6,1,14,14,5,15
1,0022000504,1610612765,Pistons,DET,Detroit,240.000000:00,107,53,32,21,12,0,12,27,4,1,5,0,15,14,5,15
0,0022000505,1610612754,Pacers,IND,Indiana,240.000000:00,112,38,28,10,12,0,3,7,4,3,7,1,12,13,4,13
1,0022000505,1610612738,Celtics,BOS,Boston,240.000000:00,118,49,22,27,17,1,11,27,3,0,3,1,11,12,5,12
0,0022000506,1610612745,Rockets,HOU,Houston,240.000000:00,111,57,27,30,11,0,10,22,4,2,6,1,9,9,4,10
1,0022000506,1610612761,Raptors,TOR,Toronto,240.000000:00,122,66,33,33,10,1,7,20,1,3,4,0,9,6,3,9
0,0022000507,1610612762,Jazz,UTA,Utah,240.000000:00,116,40,29,11,11,0,7,18,4,5,9,0,6,5,1,6
1,0022000507,1610612748,Heat,MIA,Miami,240.000000:00,124,51,26,25,13,1,17,38,2,4,6,0,19,18,7,19
0,0022000508,1610612756,Suns,PHX,Phoenix,240.000000:00,106,46,32,14,14,0,12,24,3,7,10,2,6,8,4,8
1,0022000508,1610612741,Bulls,CHI,Chicago,240.000000:00,97,56,44,12,8,1,17,39,2,4,6,2,7,9,4,9
0,0022000509,1610612746,Clippers,LAC,LA,240.000000:00,119,70,53,17,11,0,7,17,2,4,6,1,12,9,5,13
1,0022000509,1610612763,Grizzlies,MEM,Memphis,240.000000:00,99,55,31,24,13,1,12,28,4,3,7,0,11,8,5,11
0,0022000510,1610612737,Hawks,ATL,Atlanta,240.000000:00,109,48,27,21,13,1,9,19,4,5,9,3,9,12,4,12
1,0022000510,1610612760,Thunder,OKC,Oklahoma City,240.000000:00,118,57,34,23,13,0,5,11,2,3,5,0,10,9,4,10
0,0022000511,1610612766,Hornets,CHA,Charlotte,240.000000:00,121,31,24,7,18,0,8,19,4,2,6,1,6,6,4,7
1,0022000511,1610612744,Warriors,GSW,Golden State,240.000000:00,130,47,23,24,18,1,10,23,6,5,11,0,9,8,2,9
0,0022000512,1610612757,Trail Blazers,POR,Portland,240.000000:00,93,47,35,12,11,0,9,22,4,2,6,2,3,4,4,5
1,0022000512,1610612747,Lakers,LAL,Los Angeles,240.000000:00,102,55,27,28,19,2,3,6,6,2,8,0,7,5,1,7
0,0022000513,1610612739,Cavaliers,CLE,Cleveland,265.000000:00,112,53,36,17,11,3,14,30,3,4,7,1,5,4,2,6
1,0022000513,1610612755,76ers,PHI,Philadelphia,265.000000:00,109,48,36,12,16,1,1,2,2,4,6,4,7,9,6,11
0,0022000514,1610612740,Pelicans,NOP,New Orleans,240.000000:00,114,54,32,22,7,0,10,23,8,0,8,6,7,12,6,13
1,0022000514,1610612759,Spurs,SAS,San Antonio,240.000000:00,117,47,31,16,18,0,12,25,1,1,2,2,10,10,8,12
0,0022000515,1610612754,Pacers,IND,Indiana,240.000000:00,107,56,37,19,17,0,12,26,2,3,5,0,19,12,3,19
1,0022000515,1610612752,Knicks,NYK,New York,240.000000:00,110,49,28,21,17,0,13,29,3,5,8,3,24,20,4,27
0,0022000516,1610612762,Jazz,UTA,Utah,240.000000:00,124,64,43,21,13,0,13,31,3,1,4,2,4,6,1,6
1,0022000516,1610612753,Magic,ORL,Orlando,240.000000:00,109,37,19,18,22,1,17,36,2,5,7,1,8,9,4,9
0,0022000517,1610612750,Timberwolves,MIN,Minnesota,240.000000:00,112,54,36,18,17,1,7,17,2,1,3,1,8,6,2,9
1,0022000517,1610612764,Wizards,WAS,Washington,240.000000:00,128,62,37,25,18,3,19,42,4,2,6,6,12,16,3,18
0,0022000518,1610612743,Nuggets,DEN,Denver,240.000000:00,126,48,16,32,10,0,21,50,2,0,2,1,5,5,2,6
1,0022000518,1610612760,Thunder,OKC,Oklahoma City,240.000000:00,96,59,34,25,11,0,7,16,2,0,2,1,4,4,2,5
0,0022000519,1610612742,Mavericks,DAL,Dallas,240.000000:00,115,51,26,25,16,0,1,2,4,2,6,1,4,4,2,5
1,0022000519,1610612751,Nets,BKN,Brooklyn,240.000000:00,98,55,29,26,12,0,8,23,4,1,5,1,10,10,5,11
0,0022000520,1610612746,Clippers,LAC,LA,240.000000:00,100,52,29,23,15,1,15,32,3,0,3,2,9,7,2,11
1,0022000520,1610612749,Bucks,MIL,Milwaukee,240.000000:00,105,80,48,32,13,1,4,9,3,1,4,0,12,9,2,12
0,0022000521,1610612752,Knicks,NYK,New York,240.000000:00,109,49,30,19,17,0,13,28,4,4,8,0,6,5,4,6
1,0022000521,1610612765,Pistons,DET,Detroit,240.000000:00,90,68,47,21,13,1,12,28,3,2,5,1,15,13,3,16
0,0022000522,1610612737,Hawks,ATL,Atlanta,240.000000:00,99,50,28,22,14,0,1,3,5,1,6,6,1,7,5,7
1,0022000522,1610612748,Heat,MIA,Miami,240.000000:00,109,49,30,19,9,0,10,20,2,4,6,2,22,19,5,24
0,0022000523,1610612741,Bulls,CHI,Chicago,240.000000:00,122,59,33,26,14,0,9,20,4,2,6,1,5,6,4,6
1,0022000523,1610612761,Raptors,TOR,Toronto,240.000000:00,113,59,36,23,19,1,3,6,3,4,7,4,2,5,4,6
0,0022000524,1610612764,Wizards,WAS,Washington,240.000000:00,110,51,37,14,12,1,11,25,3,4,7,1,6,7,2,7
1,0022000524,1610612738,Celtics,BOS,Boston,240.000000:00,111,45,31,14,14,0,6,15,7,1,8,3,8,10,8,11
0,0022000525,1610612763,Grizzlies,MEM,Memphis,240.000000:00,133,52,25,27,23,0,7,14,4,6,10,1,15,16,7,17
1,0022000525,1610612745,Rockets,HOU,Houston,240.000000:00,84,48,29,19,26,0,7,15,3,3,6,1,11,11,4,12
0,0022000526,1610612756,Suns,PHX,Phoenix,240.000000:00,118,48,27,21,13,0,12,25,5,4,9,0,6,6,1,6
1,0022000526,1610612750,Timberwolves,MIN,Minnesota,240.000000:00,99,46,31,15,15,0,5,13,5,4,9,1,2,2,1,3
0,0022000527,1610612744,Warriors,GSW,Golden State,240.000000:00,91,47,29,18,24,1,12,29,0,3,3,0,13,5,3,13
1,0022000527,1610612747,Lakers,LAL,Los Angeles,240.000000:00,117,46,31,15,20,2,9,22,3,3,6,6,11,14,6,17
0,0022000528,1610612766,Hornets,CHA,Charlotte,240.000000:00,127,47,29,18,13,0,9,19,6,0,6,2,6,5,3,8
1,0022000528,1610612758,Kings,SAC,Sacramento,240.000000:00,126,41,24,17,15,2,7,16,7,1,8,4,3,6,5,7
0,0022000529,1610612742,Mavericks,DAL,Dallas,240.000000:00,130,66,42,24,8,0,11,24,4,5,9,2,8,6,3,10
1,0022000529,1610612753,Magic,ORL,Orlando,240.000000:00,124,45,17,28,10,0,15,34,0,3,3,2,8,7,4,10
0,0022000530,1610612754,Pacers,IND,Indiana,240.000000:00,114,38,21,17,20,0,17,38,3,1,4,1,5,5,2,6
1,0022000530,1610612755,76ers,PHI,Philadelphia,240.000000:00,130,37,25,12,15,0,7,15,0,3,3,2,5,5,3,7
0,0022000531,1610612743,Nuggets,DEN,Denver,240.000000:00,118,61,36,25,9,0,11,24,1,5,6,3,16,15,7,19
1,0022000531,1610612741,Bulls,CHI,Chicago,240.000000:00,112,67,44,23,9,1,10,23,3,2,5,2,10,10,4,12
0,0022000532,1610612739,Cavaliers,CLE,Cleveland,240.000000:00,101,54,29,25,12,1,17,39,2,3,5,0,6,5,0,6
1,0022000532,1610612745,Rockets,HOU,Houston,240.000000:00,90,48,23,25,21,1,7,15,1,2,3,0,6,5,0,6
0,0022000533,1610612762,Jazz,UTA,Utah,240.000000:00,124,39,34,5,15,0,11,28,4,5,9,1,7,7,3,8
1,0022000533,1610612740,Pelicans,NOP,New Orleans,240.000000:00,129,50,32,18,7,0,14,29,6,2,8,3,8,9,5,11
0,0022000534,1610612751,Nets,BKN,Brooklyn,265.000000:00,124,62,46,16,14,0,10,25,5,1,6,0,16,16,3,16
1,0022000534,1610612759,Spurs,SAS,San Antonio,265.000000:00,113,49,33,16,18,0,9,20,3,1,4,1,14,11,4,15
0,0022000535,1610612766,Hornets,CHA,Charlotte,240.000000:00,111,46,21,25,17,2,5,11,4,3,7,0,6,1,1,6
1,0022000535,1610612757,Trail Blazers,POR,Portland,240.000000:00,123,43,20,23,24,1,13,31,2,2,4,3,1,4,3,4
0,0022000536,1610612763,Grizzlies,MEM,Memphis,240.000000:00,125,48,28,20,16,1,14,29,4,9,13,1,16,12,7,17
1,0022000536,1610612764,Wizards,WAS,Washington,240.000000:00,111,61,45,16,13,2,12,29,4,4,8,0,18,14,4,18
0,0022000537,1610612746,Clippers,LAC,LA,240.000000:00,112,49,30,19,13,0,8,20,7,2,9,2,10,5,3,12
1,0022000537,1610612738,Celtics,BOS,Boston,240.000000:00,117,56,30,26,10,0,11,27,3,2,5,2,6,4,3,8
0,0022000538,1610612737,Hawks,ATL,Atlanta,240.000000:00,94,45,21,24,10,1,7,17,3,4,7,5,6,9,5,11
1,0022000538,1610612748,Heat,MIA,Miami,240.000000:00,80,49,23,26,20,1,11,29,0,7,7,2,12,12,6,14
0,0022000539,1610612765,Pistons,DET,Detroit,240.000000:00,129,42,21,21,20,1,8,21,5,6,11,1,11,11,5,12
1,0022000539,1610612761,Raptors,TOR,Toronto,240.000000:00,105,55,31,24,24,1,16,40,5,3,8,1,13,13,5,14
0,0022000540,1610612743,Nuggets,DEN,Denver,240.000000:00,128,50,23,27,12,1,23,52,3,2,5,3,15,13,6,18
1,0022000540,1610612749,Bucks,MIL,Milwaukee,240.000000:00,97,70,48,22,15,0,6,15,7,3,10,0,10,10,2,10
0,0022000541,1610612752,Knicks,NYK,New York,240.000000:00,93,62,33,29,10,2,8,19,2,0,2,0,5,4,2,5
1,0022000541,1610612759,Spurs,SAS,San Antonio,240.000000:00,119,57,35,22,17,0,8,21,3,4,7,0,7,6,3,7
0,0022000542,1610612756,Suns,PHX,Phoenix,240.000000:00,114,50,29,21,11,0,1,3,7,2,9,0,4,4,1,4
1,0022000542,1610612747,Lakers,LAL,Los Angeles,240.000000:00,104,48,32,16,9,2,13,30,2,3,5,3,7,9,4,10
0,0022000543,1610612754,Pacers,IND,Indiana,240.000000:00,114,50,31,19,33,0,11,22,3,8,11,0,6,4,2,6
1,0022000543,1610612739,Cavaliers,CLE,Cleveland,240.000000:00,111,43,30,13,17,0,10,22,6,6,12,3,11,12,9,14
0,0022000544,1610612737,Hawks,ATL,Atlanta,240.000000:00,115,49,31,18,17,1,12,28,0,0,0,0,0,0,0,0
1,0022000544,1610612753,Magic,ORL,Orlando,240.000000:00,112,48,22,26,10,2,9,20,3,4,7,1,4,4,2,5
0,0022000545,1610612762,Jazz,UTA,Utah,265.000000:00,123,67,48,19,6,0,18,47,3,4,7,0,1,1,0,1
1,0022000545,1610612755,76ers,PHI,Philadelphia,265.000000:00,131,62,35,27,21,0,11,24,1,3,4,2,6,7,6,8
0,0022000546,1610612751,Nets,BKN,Brooklyn,240.000000:00,132,57,34,23,9,1,12,30,4,1,5,2,15,7,2,17
1,0022000546,1610612745,Rockets,HOU,Houston,240.000000:00,114,37,21,16,12,0,8,22,4,3,7,2,14,9,4,16
0,0022000547,1610612766,Hornets,CHA,Charlotte,240.000000:00,135,52,25,27,12,1,8,18,6,7,13,3,14,12,7,17
1,0022000547,1610612750,Timberwolves,MIN,Minnesota,240.000000:00,102,61,37,24,12,0,3,8,4,6,10,1,4,5,3,5
0,0022000548,1610612741,Bulls,CHI,Chicago,240.000000:00,128,55,38,17,16,0,17,39,1,3,4,2,8,10,6,10
1,0022000548,1610612740,Pelicans,NOP,New Orleans,240.000000:00,124,52,38,14,17,0,19,40,2,5,7,3,8,10,6,11
0,0022000549,1610612760,Thunder,OKC,Oklahoma City,240.000000:00,78,52,24,28,11,0,8,21,0,2,2,2,4,5,3,6
1,0022000549,1610612742,Mavericks,DAL,Dallas,240.000000:00,87,55,31,24,14,2,11,25,1,7,8,2,12,11,4,14
0,0022000550,1610612744,Warriors,GSW,Golden State,240.000000:00,106,65,26,39,16,0,9,22,4,2,6,0,9,7,2,9
1,0022000550,1610612757,Trail Blazers,POR,Portland,240.000000:00,108,52,24,28,9,1,5,12,4,3,7,2,3,5,3,5
0,0022000551,1610612747,Lakers,LAL,Los Angeles,240.000000:00,120,45,31,14,15,1,15,33,2,1,3,4,18,16,8,22
1,0022000551,1610612758,Kings,SAC,Sacramento,240.000000:00,123,59,42,17,9,1,13,28,0,1,1,2,22,14,5,24
0,0022000552,1610612761,Raptors,TOR,Toronto,240.000000:00,125,39,18,21,14,0,6,17,3,1,4,0,7,2,0,7
1,0022000552,1610612738,Celtics,BOS,Boston,240.000000:00,132,57,21,36,11,1,10,23,3,6,9,2,6,6,4,8
0,0022000553,1610612743,Nuggets,DEN,Denver,240.000000:00,113,52,27,25,9,0,8,18,4,5,9,2,7,9,7,9
1,0022000553,1610612754,Pacers,IND,Indiana,240.000000:00,103,47,27,20,19,0,11,26,4,7,11,1,2,3,2,3
0,0022000554,1610612746,Clippers,LAC,LA,240.000000:00,117,61,42,19,11,0,10,21,5,3,8,3,14,8,7,17
1,0022000554,1610612764,Wizards,WAS,Washington,240.000000:00,119,62,33,29,23,2,9,19,3,3,6,1,17,12,4,18
0,0022000555,1610612749,Bucks,MIL,Milwaukee,240.000000:00,112,69,49,20,14,0,2,4,7,7,14,4,10,9,5,14
1,0022000555,1610612763,Grizzlies,MEM,Memphis,240.000000:00,111,64,40,24,20,0,13,28,1,3,4,1,17,11,3,18
0,0022000556,1610612760,Thunder,OKC,Oklahoma City,240.000000:00,107,63,38,25,14,0,6,15,3,6,9,3,9,11,5,12
1,0022000556,1610612759,Spurs,SAS,San Antonio,240.000000:00,102,55,30,25,15,1,11,24,3,5,8,4,9,10,7,13
0,0022000557,1610612748,Heat,MIA,Miami,240.000000:00,103,52,27,25,11,1,7,17,3,5,8,3,10,10,6,13
1,0022000557,1610612740,Pelicans,NOP,New Orleans,240.000000:00,93,46,29,17,12,1,5,11,6,4,10,4,3,6,5,7
0,0022000558,1610612758,Kings,SAC,Sacramento,240.000000:00,119,62,33,29,5,0,8,17,3,0,3,0,6,5,2,6
1,0022000558,1610612757,Trail Blazers,POR,Portland,240.000000:00,123,59,42,17,9,0,13,35,0,2,2,3,5,8,7,8
0,0022000559,1610612757,Trail Blazers,POR,Portland,240.000000:00,132,43,21,22,14,1,5,14,3,0,3,4,7,9,8,11
1,0022000559,1610612764,Wizards,WAS,Washington,240.000000:00,121,76,39,37,11,3,11,27,3,2,5,2,8,8,7,10
0,0022000560,1610612738,Celtics,BOS,Boston,240.000000:00,91,53,37,16,9,3,11,26,3,0,3,2,12,9,5,14
1,0022000560,1610612764,Wizards,WAS,Washington,240.000000:00,104,57,35,22,13,2,8,19,4,4,8,0,13,10,3,13
0,0022000561,1610612740,Pelicans,NOP,New Orleans,240.000000:00,112,43,27,16,14,3,15,36,1,4,5,3,6,9,6,9
1,0022000561,1610612765,Pistons,DET,Detroit,240.000000:00,123,45,34,11,15,0,9,25,1,3,4,0,7,5,2,7
0,0022000562,1610612760,Thunder,OKC,Oklahoma City,240.000000:00,113,56,39,17,6,0,3,8,5,4,9,1,10,9,4,11
1,0022000562,1610612763,Grizzlies,MEM,Memphis,240.000000:00,122,61,29,32,16,0,9,22,1,7,8,1,9,8,4,10
0,0022000563,1610612743,Nuggets,DEN,Denver,240.000000:00,120,37,26,11,20,1,22,52,4,5,9,2,7,9,4,9
1,0022000563,1610612739,Cavaliers,CLE,Cleveland,240.000000:00,103,53,35,18,10,0,7,18,0,4,4,2,3,5,2,5
0,0022000564,1610612765,Pistons,DET,Detroit,240.000000:00,102,40,27,13,11,0,13,29,3,7,10,1,14,12,6,15
1,0022000564,1610612741,Bulls,CHI,Chicago,240.000000:00,105,58,39,19,16,0,7,17,2,2,4,0,8,6,2,8
0,0022000565,1610612765,Pistons,DET,Detroit,240.000000:00,104,44,30,14,10,0,7,17,0,2,2,1,5,6,1,6
1,0022000565,1610612752,Knicks,NYK,New York,240.000000:00,114,51,29,22,11,0,10,21,2,3,5,2,4,6,4,6
0,0022000566,1610612764,Wizards,WAS,Washington,240.000000:00,112,54,42,12,11,1,7,16,3,1,4,1,12,10,2,13
1,0022000566,1610612763,Grizzlies,MEM,Memphis,240.000000:00,127,61,44,17,13,0,12,26,1,3,4,3,13,15,6,16
0,0022000567,1610612759,Spurs,SAS,San Antonio,240.000000:00,104,45,21,24,14,1,9,20,6,4,10,2,2,4,3,4
1,0022000567,1610612742,Mavericks,DAL,Dallas,240.000000:00,115,52,35,17,12,2,8,17,7,3,10,2,9,10,4,11
0,0022000568,1610612765,Pistons,DET,Detroit,240.000000:00,102,52,32,20,14,0,5,14,0,1,1,1,6,7,4,7
1,0022000568,1610612766,Hornets,CHA,Charlotte,240.000000:00,105,39,16,23,20,0,6,14,1,2,3,3,2,5,4,5
0,0022000569,1610612738,Celtics,BOS,Boston,240.000000:00,109,52,28,24,16,0,14,33,4,4,8,5,4,9,6,9
1,0022000569,1610612751,Nets,BKN,Brooklyn,240.000000:00,121,50,30,20,14,0,11,28,4,2,6,1,11,11,9,12
0,0022000570,1610612737,Hawks,ATL,Atlanta,240.000000:00,121,60,33,27,12,1,7,15,3,1,4,2,3,4,2,5
1,0022000570,1610612761,Raptors,TOR,Toronto,240.000000:00,120,60,25,35,14,2,14,38,1,2,3,0,15,14,4,15
0,0022000571,1610612753,Magic,ORL,Orlando,240.000000:00,103,60,22,38,8,0,13,29,2,2,4,1,4,4,4,5
1,0022000571,1610612748,Heat,MIA,Miami,240.000000:00,111,60,36,24,11,0,14,29,1,0,1,2,20,15,6,22
0,0022000572,1610612755,76ers,PHI,Philadelphia,240.000000:00,127,46,30,16,15,0,12,26,4,1,5,3,1,3,3,4
1,0022000572,1610612741,Bulls,CHI,Chicago,240.000000:00,105,63,40,23,5,1,19,43,1,2,3,0,5,4,3,5
0,0022000573,1610612752,Knicks,NYK,New York,240.000000:00,101,52,25,27,11,1,16,35,2,2,4,3,12,12,3,15
1,0022000573,1610612749,Bucks,MIL,Milwaukee,240.000000:00,134,57,35,22,14,0,11,27,2,0,2,1,10,8,3,11
0,0022000574,1610612750,Timberwolves,MIN,Minnesota,240.000000:00,135,69,48,21,16,2,12,30,3,5,8,1,3,4,3,4
1,0022000574,1610612740,Pelicans,NOP,New Orleans,240.000000:00,105,55,32,23,12,2,7,15,1,1,2,3,1,4,4,4
0,0022000575,1610612742,Mavericks,DAL,Dallas,240.000000:00,108,44,26,18,12,1,18,42,2,1,3,0,9,7,2,9
1,0022000575,1610612760,Thunder,OKC,Oklahoma City,240.000000:00,116,52,30,22,4,0,6,14,5,2,7,1,11,9,4,12
0,0022000576,1610612744,Warriors,GSW,Golden State,240.000000:00,104,59,37,22,13,0,8,18,3,2,5,0,5,3,2,5
1,0022000576,1610612746,Clippers,LAC,LA,240.000000:00,130,54,36,18,13,0,9,19,5,3,8,2,7,9,5,9
0,0022000577,1610612756,Suns,PHX,Phoenix,240.000000:00,127,51,25,26,10,0,19,43,0,1,1,0,3,2,1,3
1,0022000577,1610612757,Trail Blazers,POR,Portland,240.000000:00,121,29,23,6,14,0,10,25,4,1,5,5,3,8,5,8
0,0022000578,1610612745,Rockets,HOU,Houston,240.000000:00,105,61,37,24,14,0,11,27,4,4,8,1,4,3,2,5
1,0022000578,1610612758,Kings,SAC,Sacramento,240.000000:00,125,62,34,28,18,0,10,22,5,3,8,1,7,5,2,8
0,0022000579,1610612755,76ers,PHI,Philadelphia,240.000000:00,127,42,28,14,21,0,15,31,2,1,3,2,12,14,7,14
1,0022000579,1610612764,Wizards,WAS,Washington,240.000000:00,101,46,33,13,19,2,13,28,3,2,5,1,4,5,3,5
0,0022000580,1610612743,Nuggets,DEN,Denver,240.000000:00,103,51,32,19,25,0,10,24,3,5,8,6,16,16,13,22
1,0022000580,1610612763,Grizzlies,MEM,Memphis,240.000000:00,102,58,34,24,14,0,5,13,3,4,7,2,10,10,4,12
0,0022000581,1610612739,Cavaliers,CLE,Cleveland,240.000000:00,82,46,36,10,13,0,13,30,2,4,6,2,4,6,4,6
1,0022000581,1610612740,Pelicans,NOP,New Orleans,240.000000:00,116,61,37,24,8,1,13,26,4,3,7,4,7,8,4,11
0,0022000582,1610612748,Heat,MIA,Miami,240.000000:00,101,63,36,27,15,1,13,31,0,6,6,1,16,14,5,17
1,0022000582,1610612741,Bulls,CHI,Chicago,240.000000:00,90,59,29,30,7,1,6,17,7,5,12,5,9,10,6,14
0,0022000583,1610612753,Magic,ORL,Orlando,240.000000:00,77,53,33,20,8,0,3,8,5,1,6,0,6,4,2,6
1,0022000583,1610612759,Spurs,SAS,San Antonio,240.000000:00,104,54,32,22,11,1,19,40,4,3,7,3,7,9,4,10
0,0022000584,1610612745,Rockets,HOU,Houston,240.000000:00,99,38,21,17,16,3,12,27,6,4,10,2,3,3,2,5
1,0022000584,1610612762,Jazz,UTA,Utah,240.000000:00,114,59,40,19,11,0,10,23,5,4,9,2,9,9,4,11
0,0022000585,1610612754,Pacers,IND,Indiana,240.000000:00,100,49,34,15,15,2,13,30,3,2,5,0,9,5,1,9
1,0022000585,1610612747,Lakers,LAL,Los Angeles,240.000000:00,105,58,32,26,14,2,5,10,3,3,6,0,7,4,3,7
0,0022000586,1610612752,Knicks,NYK,New York,240.000000:00,119,45,29,16,18,0,16,34,0,1,1,2,7,7,2,9
1,0022000586,1610612760,Thunder,OKC,Oklahoma City,240.000000:00,97,54,36,18,15,1,8,19,1,1,2,0,7,7,3,7
0,0022000587,1610612765,Pistons,DET,Detroit,240.000000:00,95,43,26,17,16,0,7,18,4,6,10,1,7,7,4,8
1,0022000587,1610612751,Nets,BKN,Brooklyn,240.000000:00,100,58,36,22,11,1,14,34,3,3,6,0,3,3,2,3
0,0022000588,1610612761,Raptors,TOR,Toronto,240.000000:00,104,51,22,29,13,2,4,10,5,4,9,2,6,8,3,8
1,0022000588,1610612766,Hornets,CHA,Charlotte,240.000000:00,114,52,31,21,17,1,2,6,4,3,7,1,1,2,2,2
0,0022000589,1610612749,Bucks,MIL,Milwaukee,240.000000:00,125,58,33,25,11,1,4,10,5,1,6,0,6,2,0,6
1,0022000589,1610612764,Wizards,WAS,Washington,240.000000:00,119,56,32,24,12,0,8,21,2,4,6,0,3,3,0,3
0,0022000590,1610612758,Kings,SAC,Sacramento,240.000000:00,106,41,22,19,10,0,12,26,6,0,6,1,11,10,5,12
1,0022000590,1610612737,Hawks,ATL,Atlanta,240.000000:00,121,51,33,18,15,0,8,17,0,2,2,1,21,18,4,22
0,0022000591,1610612757,Trail Blazers,POR,Portland,240.000000:00,125,50,31,19,11,1,12,30,0,1,1,1,3,4,0,4
1,0022000591,1610612750,Timberwolves,MIN,Minnesota,240.000000:00,121,68,37,31,7,0,5,12,4,2,6,0,5,4,1,5
0,0022000592,1610612742,Mavericks,DAL,Dallas,240.000000:00,116,49,27,22,7,1,8,20,7,1,8,0,15,14,6,15
1,0022000592,1610612743,Nuggets,DEN,Denver,240.000000:00,103,47,20,27,19,0,7,19,3,3,6,4,6,10,4,10
0,0022000593,1610612763,Grizzlies,MEM,Memphis,240.000000:00,122,45,28,17,20,0,24,50,1,6,7,5,13,8,6,18
1,0022000593,1610612760,Thunder,OKC,Oklahoma City,240.000000:00,128,61,49,12,16,0,12,29,3,4,7,1,10,9,2,11
0,0022000594,1610612762,Jazz,UTA,Utah,240.000000:00,119,49,33,16,11,1,5,13,4,3,7,6,13,17,12,19
1,0022000594,1610612744,Warriors,GSW,Golden State,240.000000:00,131,64,33,31,13,0,15,37,3,9,12,0,8,7,1,8
0,0022000595,1610612759,Spurs,SAS,San Antonio,240.000000:00,99,69,45,24,14,0,15,33,4,6,10,0,3,3,2,3
1,0022000595,1610612755,76ers,PHI,Philadelphia,240.000000:00,134,48,37,11,13,0,16,33,4,3,7,1,6,7,4,7
0,0022000596,1610612748,Heat,MIA,Miami,240.000000:00,102,45,23,22,23,1,7,18,1,3,4,5,8,10,5,13
1,0022000596,1610612753,Magic,ORL,Orlando,240.000000:00,97,43,16,27,10,0,7,17,5,2,7,4,9,11,3,13
0,0022000597,1610612739,Cavaliers,CLE,Cleveland,240.000000:00,82,53,32,21,10,1,12,28,3,2,5,0,6,4,1,6
1,0022000597,1610612737,Hawks,ATL,Atlanta,240.000000:00,100,47,27,20,10,0,6,15,3,3,6,2,10,11,5,12
0,0022000598,1610612738,Celtics,BOS,Boston,240.000000:00,134,52,24,28,14,1,7,17,3,3,6,6,5,11,10,11
1,0022000598,1610612745,Rockets,HOU,Houston,240.000000:00,107,56,33,23,11,0,5,12,3,3,6,1,6,7,1,7
0,0022000599,1610612757,Trail Blazers,POR,Portland,240.000000:00,112,39,15,24,16,1,12,29,3,1,4,1,11,8,4,12
1,0022000599,1610612750,Timberwolves,MIN,Minnesota,240.000000:00,114,63,32,31,11,0,12,31,2,5,7,2,10,12,3,12
0,0022000600,1610612761,Raptors,TOR,Toronto,240.000000:00,95,55,34,21,13,0,15,36,1,1,2,1,11,12,2,12
1,0022000600,1610612741,Bulls,CHI,Chicago,240.000000:00,118,55,34,21,14,1,5,10,6,4,10,1,13,14,3,14
0,0022000601,1610612746,Clippers,LAC,LA,240.000000:00,115,34,21,13,19,1,9,23,3,3,6,0,5,4,0,5
1,0022000601,1610612740,Pelicans,NOP,New Orleans,240.000000:00,135,50,25,25,11,0,8,17,1,3,4,0,3,3,1,3
0,0022000602,1610612758,Kings,SAC,Sacramento,240.000000:00,116,53,30,23,11,0,8,17,3,4,7,0,8,6,1,8
1,0022000602,1610612766,Hornets,CHA,Charlotte,240.000000:00,122,48,30,18,18,0,6,13,2,2,4,1,9,10,2,10
0,0022000603,1610612749,Bucks,MIL,Milwaukee,240.000000:00,133,51,29,22,11,1,9,21,3,1,4,1,2,3,1,3
1,0022000603,1610612764,Wizards,WAS,Washington,240.000000:00,122,65,45,20,17,3,11,26,1,2,3,0,5,5,0,5
0,0022000604,1610612752,Knicks,NYK,New York,240.000000:00,112,48,27,21,17,0,11,27,3,3,6,2,3,5,2,5
1,0022000604,1610612751,Nets,BKN,Brooklyn,240.000000:00,117,53,31,22,11,0,10,24,1,3,4,0,12,10,7,12
0,0022000605,1610612746,Clippers,LAC,LA,240.000000:00,109,57,24,33,17,0,9,19,3,4,7,1,3,3,1,4
1,0022000605,1610612742,Mavericks,DAL,Dallas,240.000000:00,99,52,34,18,12,0,9,22,4,2,6,0,7,7,5,7
0,0022000606,1610612754,Pacers,IND,Indiana,240.000000:00,106,55,43,12,11,1,7,18,6,3,9,3,5,5,4,8
1,0022000606,1610612743,Nuggets,DEN,Denver,240.000000:00,121,61,34,27,15,0,13,32,7,5,12,5,6,8,7,11
0,0022000607,1610612763,Grizzlies,MEM,Memphis,240.000000:00,99,49,32,17,12,0,7,14,3,9,12,2,3,2,0,5
1,0022000607,1610612756,Suns,PHX,Phoenix,240.000000:00,122,62,44,18,11,0,11,23,4,2,6,1,3,4,3,4
0,0022000608,1610612747,Lakers,LAL,Los Angeles,240.000000:00,128,36,20,16,8,4,12,30,4,1,5,0,10,9,2,10
1,0022000608,1610612744,Warriors,GSW,Golden State,240.000000:00,97,38,19,19,22,1,12,28,3,1,4,3,13,8,4,16
0,0022000609,1610612762,Jazz,UTA,Utah,240.000000:00,117,48,33,15,11,1,13,35,1,2,3,3,4,7,5,7
1,0022000609,1610612738,Celtics,BOS,Boston,240.000000:00,109,37,17,20,18,2,17,39,4,4,8,2,5,7,7,7
0,0022000610,1610612739,Cavaliers,CLE,Cleveland,240.000000:00,98,40,28,12,14,1,4,9,6,1,7,7,4,9,7,11
1,0022000610,1610612748,Heat,MIA,Miami,240.000000:00,113,39,19,20,18,0,10,23,6,6,12,5,10,14,7,15
0,0022000611,1610612752,Knicks,NYK,New York,240.000000:00,96,58,34,24,11,0,13,29,5,1,6,1,9,9,4,10
1,0022000611,1610612755,76ers,PHI,Philadelphia,240.000000:00,99,44,35,9,15,0,7,16,3,4,7,0,8,7,1,8
0,0022000612,1610612760,Thunder,OKC,Oklahoma City,240.000000:00,102,51,33,18,15,0,7,14,2,1,3,0,6,4,3,6
1,0022000612,1610612741,Bulls,CHI,Chicago,240.000000:00,123,39,33,6,12,1,14,32,5,2,7,2,12,12,5,14
0,0022000613,1610612737,Hawks,ATL,Atlanta,240.000000:00,119,54,29,25,19,0,4,8,2,3,5,1,4,4,3,5
1,0022000613,1610612745,Rockets,HOU,Houston,240.000000:00,107,56,28,28,13,0,7,18,4,4,8,0,5,4,3,5
0,0022000614,1610612740,Pelicans,NOP,New Orleans,240.000000:00,124,45,16,29,16,0,10,24,3,3,6,4,6,7,4,10
1,0022000614,1610612757,Trail Blazers,POR,Portland,240.000000:00,125,52,30,22,10,0,18,45,2,5,7,0,2,2,0,2
0,0022000615,1610612750,Timberwolves,MIN,Minnesota,240.000000:00,121,53,38,15,11,0,8,18,3,2,5,1,4,5,3,5
1,0022000615,1610612747,Lakers,LAL,Los Angeles,240.000000:00,137,54,34,20,8,3,9,21,0,1,1,2,5,6,5,7
0,0022000616,1610612761,Raptors,TOR,Toronto,240.000000:00,112,43,21,22,18,3,15,38,2,2,4,4,6,10,5,10
1,0022000616,1610612765,Pistons,DET,Detroit,240.000000:00,116,39,19,20,8,0,4,9,2,3,5,5,15,20,9,20
0,0022000617,1610612751,Nets,BKN,Brooklyn,240.000000:00,124,47,29,18,19,0,7,17,4,7,11,1,9,8,4,10
1,0022000617,1610612754,Pacers,IND,Indiana,240.000000:00,115,48,31,17,22,0,7,17,4,5,9,0,3,3,2,3
0,0022000618,1610612749,Bucks,MIL,Milwaukee,265.000000:00,109,73,45,28,25,1,7,15,1,3,4,1,11,11,4,12
1,0022000618,1610612755,76ers,PHI,Philadelphia,265.000000:00,105,56,32,24,22,1,11,23,2,2,4,1,21,18,3,22
0,0022000619,1610612758,Kings,SAC,Sacramento,240.000000:00,121,42,30,12,15,1,8,19,7,7,14,4,9,10,7,13
1,0022000619,1610612764,Wizards,WAS,Washington,240.000000:00,119,67,46,21,12,0,9,19,4,3,7,4,11,11,7,15
0,0022000620,1610612738,Celtics,BOS,Boston,240.000000:00,110,41,32,9,23,0,13,30,4,4,8,1,8,7,2,9
1,0022000620,1610612739,Cavaliers,CLE,Cleveland,240.000000:00,117,55,30,25,12,0,13,32,4,1,5,0,5,4,3,5
0,0022000621,1610612759,Spurs,SAS,San Antonio,240.000000:00,106,60,40,20,15,1,9,22,2,4,6,0,5,4,1,5
1,0022000621,1610612741,Bulls,CHI,Chicago,240.000000:00,99,54,41,13,11,0,12,28,4,2,6,1,12,13,2,13
0,0022000622,1610612744,Warriors,GSW,Golden State,240.000000:00,108,50,36,14,22,1,9,21,3,2,5,1,10,10,6,11
1,0022000622,1610612745,Rockets,HOU,Houston,240.000000:00,94,49,25,24,12,0,4,9,0,4,4,3,8,10,5,11
0,0022000623,1610612748,Heat,MIA,Miami,240.000000:00,85,60,30,30,14,1,13,29,1,1,2,0,6,5,1,6
1,0022000623,1610612763,Grizzlies,MEM,Memphis,240.000000:00,89,52,33,19,14,1,5,11,0,2,2,1,13,11,2,14
0,0022000624,1610612766,Hornets,CHA,Charlotte,240.000000:00,104,51,19,32,18,0,4,10,3,6,9,0,7,4,1,7
1,0022000624,1610612743,Nuggets,DEN,Denver,240.000000:00,129,40,16,24,19,1,3,7,3,2,5,3,5,5,3,8
0,0022000625,1610612746,Clippers,LAC,LA,240.000000:00,89,43,23,20,21,1,11,28,6,3,9,2,6,8,2,8
1,0022000625,1610612742,Mavericks,DAL,Dallas,240.000000:00,105,45,32,13,16,0,17,39,7,2,9,2,5,6,3,7
0,0022000626,1610612760,Thunder,OKC,Oklahoma City,240.000000:00,93,47,24,23,12,1,1,3,5,1,6,2,7,6,0,9
1,0022000626,1610612737,Hawks,ATL,Atlanta,240.000000:00,116,61,41,20,20,0,21,49,2,4,6,2,11,13,4,13
0,0022000627,1610612753,Magic,ORL,Orlando,240.000000:00,93,44,27,17,14,0,8,19,1,3,4,0,17,16,9,17
1,0022000627,1610612752,Knicks,NYK,New York,240.000000:00,94,47,30,17,15,0,10,25,3,5,8,0,7,6,4,7
0,0022000628,1610612750,Timberwolves,MIN,Minnesota,240.000000:00,123,47,26,21,18,0,8,18,3,3,6,0,5,5,1,5
1,0022000628,1610612756,Suns,PHX,Phoenix,240.000000:00,119,55,29,26,15,0,11,25,2,2,4,1,13,11,5,14
0,0022000629,1610612740,Pelicans,NOP,New Orleans,240.000000:00,93,63,36,27,11,1,7,16,3,1,4,2,5,7,5,7
1,0022000629,1610612757,Trail Blazers,POR,Portland,240.000000:00,101,49,25,24,8,1,8,22,4,3,7,3,5,8,5,8
0,0022000630,1610612766,Hornets,CHA,Charlotte,240.000000:00,105,51,27,24,12,0,9,20,4,1,5,1,4,3,2,5
1,0022000630,1610612747,Lakers,LAL,Los Angeles,240.000000:00,116,37,22,15,17,2,8,18,3,2,5,2,7,8,6,9
0,0022000631,1610612758,Kings,SAC,Sacramento,240.000000:00,107,52,29,23,9,0,4,10,1,2,3,1,10,8,2,11
1,0022000631,1610612738,Celtics,BOS,Boston,240.000000:00,96,51,33,18,13,1,11,28,1,2,3,1,8,8,3,9
0,0022000632,1610612754,Pacers,IND,Indiana,240.000000:00,137,63,44,19,12,2,7,17,3,3,6,2,5,6,4,7
1,0022000632,1610612748,Heat,MIA,Miami,240.000000:00,110,63,32,31,25,0,11,24,3,2,5,1,12,10,5,13
0,0022000633,1610612751,Nets,BKN,Brooklyn,240.000000:00,113,45,27,18,21,1,19,42,3,2,5,2,12,13,7,14
1,0022000633,1610612753,Magic,ORL,Orlando,240.000000:00,121,40,24,16,7,1,15,39,4,2,6,5,12,15,8,17
0,0022000634,1610612762,Jazz,UTA,Utah,240.000000:00,115,39,20,19,8,0,7,15,3,3,6,2,8,9,6,10
1,0022000634,1610612761,Raptors,TOR,Toronto,240.000000:00,112,41,20,21,15,0,14,36,1,3,4,0,12,7,4,12
0,0022000635,1610612765,Pistons,DET,Detroit,240.000000:00,113,52,32,20,15,0,4,10,1,1,2,3,2,5,4,5
1,0022000635,1610612745,Rockets,HOU,Houston,240.000000:00,100,58,41,17,9,0,6,14,5,5,10,2,2,4,3,4
0,0022000636,1610612744,Warriors,GSW,Golden State,240.000000:00,116,53,35,18,18,0,13,33,8,4,12,0,11,7,1,11
1,0022000636,1610612763,Grizzlies,MEM,Memphis,240.000000:00,103,60,31,29,20,0,6,12,0,2,2,3,4,6,4,7
0,0022000637,1610612741,Bulls,CHI,Chicago,265.000000:00,127,54,31,23,9,1,13,28,1,6,7,0,11,6,0,11
1,0022000637,1610612743,Nuggets,DEN,Denver,265.000000:00,131,47,32,15,16,0,9,19,2,2,4,5,8,11,8,13
0,0022000638,1610612750,Timberwolves,MIN,Minnesota,240.000000:00,101,47,36,11,16,3,9,21,3,2,5,0,8,6,3,8
1,0022000638,1610612756,Suns,PHX,Phoenix,240.000000:00,113,43,27,16,18,2,14,29,4,2,6,1,8,8,2,9
0,0022000639,1610612742,Mavericks,DAL,Dallas,240.000000:00,119,53,27,26,14,0,13,30,2,4,6,4,8,8,3,12
1,0022000639,1610612757,Trail Blazers,POR,Portland,240.000000:00,125,41,17,24,13,0,15,37,0,2,2,6,2,7,6,8
0,0022000640,1610612737,Hawks,ATL,Atlanta,240.000000:00,99,46,31,15,15,0,9,20,1,2,3,1,5,5,4,6
1,0022000640,1610612747,Lakers,LAL,Los Angeles,240.000000:00,94,60,37,23,12,0,5,10,1,3,4,2,7,7,6,9
0,0022000641,1610612758,Kings,SAC,Sacramento,240.000000:00,105,55,41,14,8,0,9,19,4,3,7,2,5,4,3,7
1,0022000641,1610612755,76ers,PHI,Philadelphia,240.000000:00,129,60,40,20,15,0,17,37,2,2,4,2,9,7,3,11
0,0022000642,1610612744,Warriors,GSW,Golden State,240.000000:00,103,51,35,16,13,0,12,28,4,7,11,0,5,3,1,5
1,0022000642,1610612763,Grizzlies,MEM,Memphis,240.000000:00,111,49,32,17,13,0,6,14,4,1,5,0,3,3,0,3
0,0022000643,1610612759,Spurs,SAS,San Antonio,240.000000:00,113,47,27,20,15,0,16,33,1,4,5,1,9,8,3,10
1,0022000643,1610612749,Bucks,MIL,Milwaukee,240.000000:00,120,70,46,24,13,0,14,32,2,0,2,0,8,7,0,8
0,0022000644,1610612766,Hornets,CHA,Charlotte,240.000000:00,98,50,30,20,19,0,3,8,1,2,3,3,2,5,4,5
1,0022000644,1610612746,Clippers,LAC,LA,240.000000:00,125,45,21,24,14,0,9,22,6,2,8,3,11,9,3,14
0,0022000645,1610612754,Pacers,IND,Indiana,265.000000:00,109,51,35,16,22,1,3,6,3,1,4,2,9,10,4,11
1,0022000645,1610612748,Heat,MIA,Miami,265.000000:00,106,61,32,29,14,2,5,11,6,1,7,1,14,10,2,15
0,0022000646,1610612740,Pelicans,NOP,New Orleans,240.000000:00,113,48,29,19,15,2,7,14,4,5,9,6,11,12,6,17
1,0022000646,1610612743,Nuggets,DEN,Denver,240.000000:00,108,52,31,21,18,0,14,35,4,3,7,0,9,4,0,9
0,0022000647,1610612764,Wizards,WAS,Washington,240.000000:00,106,49,35,14,12,0,4,10,5,1,6,0,1,1,1,1
1,0022000647,1610612751,Nets,BKN,Brooklyn,240.000000:00,113,43,34,9,18,4,3,7,4,3,7,2,2,3,2,4
0,0022000648,1610612761,Raptors,TOR,Toronto,240.000000:00,105,48,25,23,22,0,11,28,2,4,6,2,12,12,3,14
1,0022000648,1610612739,Cavaliers,CLE,Cleveland,240.000000:00,116,55,32,23,14,0,7,18,5,6,11,0,13,10,2,13
0,0022000649,1610612741,Bulls,CHI,Chicago,240.000000:00,100,54,39,15,14,1,12,28,4,3,7,1,6,7,3,7
1,0022000649,1610612765,Pistons,DET,Detroit,240.000000:00,86,40,27,13,21,1,15,31,4,0,4,0,6,6,2,6
0,0022000650,1610612755,76ers,PHI,Philadelphia,265.000000:00,101,62,46,16,28,0,9,18,2,9,11,2,7,5,3,9
1,0022000650,1610612752,Knicks,NYK,New York,265.000000:00,100,50,36,14,24,0,6,12,4,4,8,4,13,16,10,17
0,0022000651,1610612747,Lakers,LAL,Los Angeles,240.000000:00,94,51,35,16,9,3,12,25,1,4,5,2,17,15,8,19
1,0022000651,1610612756,Suns,PHX,Phoenix,240.000000:00,111,62,41,21,14,0,3,6,3,5,8,1,2,3,2,3
0,0022000652,1610612742,Mavericks,DAL,Dallas,240.000000:00,132,56,29,27,10,0,10,25,0,1,1,1,6,7,2,7
1,0022000652,1610612757,Trail Blazers,POR,Portland,240.000000:00,92,59,30,29,15,0,11,22,3,0,3,0,3,2,0,3
0,0022000653,1610612758,Kings,SAC,Sacramento,240.000000:00,119,53,41,12,8,0,15,34,3,3,6,4,4,6,5,8
1,0022000653,1610612739,Cavaliers,CLE,Cleveland,240.000000:00,105,52,36,16,13,0,5,12,0,5,5,1,7,5,3,8
0,0022000654,1610612760,Thunder,OKC,Oklahoma City,240.000000:00,112,61,40,21,15,0,7,17,0,1,1,1,2,3,3,3
1,0022000654,1610612750,Timberwolves,MIN,Minnesota,240.000000:00,103,47,32,15,20,0,10,22,2,0,2,0,4,4,3,4
0,0022000655,1610612766,Hornets,CHA,Charlotte,240.000000:00,100,51,32,19,9,2,12,29,0,2,2,2,8,7,3,10
1,0022000655,1610612759,Spurs,SAS,San Antonio,240.000000:00,97,51,30,21,15,0,8,18,3,2,5,1,8,9,4,9
0,0022000656,1610612762,Jazz,UTA,Utah,240.000000:00,120,59,42,17,12,0,12,28,4,3,7,2,5,6,4,7
1,0022000656,1610612741,Bulls,CHI,Chicago,240.000000:00,95,60,34,26,14,0,13,29,1,2,3,2,13,11,5,15
0,0022000657,1610612761,Raptors,TOR,Toronto,240.000000:00,99,58,31,27,13,1,8,20,5,1,6,0,10,10,5,10
1,0022000657,1610612745,Rockets,HOU,Houston,240.000000:00,117,49,23,26,10,2,7,15,3,2,5,1,4,4,3,5
0,0022000658,1610612738,Celtics,BOS,Boston,265.000000:00,126,62,42,20,11,2,14,35,4,6,10,1,8,9,8,9
1,0022000658,1610612763,Grizzlies,MEM,Memphis,265.000000:00,132,63,38,25,13,0,16,36,9,5,14,6,7,12,10,13
0,0022000659,1610612754,Pacers,IND,Indiana,240.000000:00,113,55,33,22,19,0,12,29,3,2,5,3,10,13,6,13
1,0022000659,1610612749,Bucks,MIL,Milwaukee,240.000000:00,140,50,32,18,13,0,14,34,5,2,7,2,10,11,3,12
0,0022000660,1610612737,Hawks,ATL,Atlanta,240.000000:00,110,44,24,20,14,0,13,32,3,0,3,4,8,12,8,12
1,0022000660,1610612746,Clippers,LAC,LA,240.000000:00,119,54,37,17,9,0,4,9,6,0,6,3,7,8,6,10
0,0022000661,1610612743,Nuggets,DEN,Denver,240.000000:00,110,40,30,10,17,1,12,26,3,3,6,0,2,2,0,2
1,0022000661,1610612753,Magic,ORL,Orlando,240.000000:00,99,46,30,16,14,0,8,19,1,2,3,0,7,6,3,7
0,0022000662,1610612764,Wizards,WAS,Washington,240.000000:00,113,52,34,18,14,0,5,11,3,2,5,0,8,8,0,8
1,0022000662,1610612752,Knicks,NYK,New York,240.000000:00,131,48,37,11,13,0,12,29,2,1,3,2,7,7,2,9
0,0022000663,1610612747,Lakers,LAL,Los Angeles,240.000000:00,111,61,41,20,20,2,7,17,3,4,7,1,8,5,1,9
1,0022000663,1610612740,Pelicans,NOP,New Orleans,240.000000:00,128,55,33,22,15,0,4,8,5,3,8,0,5,3,2,5
0,0022000664,1610612756,Suns,PHX,Phoenix,240.000000:00,110,49,33,16,8,3,7,15,5,4,9,3,7,8,2,10
1,0022000664,1610612748,Heat,MIA,Miami,240.000000:00,100,61,32,29,12,1,12,27,3,2,5,2,11,11,5,13
0,0022000665,1610612755,76ers,PHI,Philadelphia,240.000000:00,108,56,42,14,10,1,8,16,3,1,4,5,4,9,7,9
1,0022000665,1610612744,Warriors,GSW,Golden State,240.000000:00,98,60,46,14,10,2,12,28,1,1,2,0,3,3,2,3
0,0022000666,1610612751,Nets,BKN,Brooklyn,240.000000:00,116,50,21,29,11,1,9,21,2,4,6,1,4,4,3,5
1,0022000666,1610612757,Trail Blazers,POR,Portland,240.000000:00,112,37,21,16,6,0,5,14,1,2,3,1,1,2,1,2
0,0022000667,1610612765,Pistons,DET,Detroit,240.000000:00,111,68,43,25,16,0,10,23,2,1,3,2,9,7,3,11
1,0022000667,1610612754,Pacers,IND,Indiana,240.000000:00,116,54,36,18,14,0,14,34,4,2,6,2,4,6,5,6
0,0022000668,1610612743,Nuggets,DEN,Denver,240.000000:00,111,47,21,26,14,0,6,13,3,2,5,3,4,7,5,7
1,0022000668,1610612761,Raptors,TOR,Toronto,240.000000:00,135,56,32,24,15,1,6,17,4,0,4,0,13,13,5,13
0,0022000669,1610612738,Celtics,BOS,Boston,240.000000:00,119,59,34,25,17,1,9,22,3,1,4,2,5,7,1,7
1,0022000669,1610612749,Bucks,MIL,Milwaukee,240.000000:00,121,67,31,36,12,0,7,16,3,4,7,2,4,6,3,6
0,0022000670,1610612756,Suns,PHX,Phoenix,240.000000:00,111,56,33,23,22,0,14,31,1,2,3,2,12,10,4,14
1,0022000670,1610612753,Magic,ORL,Orlando,240.000000:00,112,48,29,19,10,1,11,24,5,5,10,3,8,11,7,11
0,0022000671,1610612739,Cavaliers,CLE,Cleveland,240.000000:00,103,57,38,19,16,0,13,30,2,1,3,0,6,6,4,6
1,0022000671,1610612741,Bulls,CHI,Chicago,240.000000:00,94,63,41,22,15,0,11,26,2,3,5,2,7,6,3,9
0,0022000672,1610612766,Hornets,CHA,Charlotte,240.000000:00,122,63,29,34,13,0,9,24,0,0,0,3,10,9,6,13
1,0022000672,1610612745,Rockets,HOU,Houston,240.000000:00,97,41,20,21,18,0,4,10,0,3,3,4,13,13,6,17
0,0022000673,1610612742,Mavericks,DAL,Dallas,240.000000:00,128,53,29,24,13,0,11,29,4,2,6,1,18,15,4,19
1,0022000673,1610612750,Timberwolves,MIN,Minnesota,240.000000:00,108,54,31,23,8,0,7,15,5,1,6,0,2,2,1,2
0,0022000674,1610612763,Grizzlies,MEM,Memphis,240.000000:00,116,59,36,23,13,0,14,31,3,2,5,3,2,5,3,5
1,0022000674,1610612760,Thunder,OKC,Oklahoma City,240.000000:00,107,52,38,14,18,0,4,9,2,2,4,1,1,2,2,2
0,0022000675,1610612746,Clippers,LAC,LA,240.000000:00,134,53,37,16,13,0,11,24,1,1,2,0,5,5,3,5
1,0022000675,1610612759,Spurs,SAS,San Antonio,240.000000:00,101,47,30,17,10,0,16,34,1,4,5,1,10,10,6,11
0,0022000676,1610612751,Nets,BKN,Brooklyn,240.000000:00,88,44,15,29,16,0,6,13,3,2,5,4,11,14,9,15
1,0022000676,1610612762,Jazz,UTA,Utah,240.000000:00,118,54,30,24,12,0,5,13,4,3,7,6,12,14,8,18
0,0022000677,1610612737,Hawks,ATL,Atlanta,240.000000:00,108,40,23,17,13,0,14,30,2,1,3,7,7,10,8,14
1,0022000677,1610612758,Kings,SAC,Sacramento,240.000000:00,110,42,28,14,5,0,12,29,5,0,5,4,10,12,5,14
0,0022000678,1610612757,Trail Blazers,POR,Portland,240.000000:00,125,45,25,20,13,1,8,18,3,0,3,5,5,8,6,10
1,0022000678,1610612748,Heat,MIA,Miami,240.000000:00,122,66,29,37,11,1,16,38,0,1,1,2,7,6,4,9
0,0022000679,1610612764,Wizards,WAS,Washington,240.000000:00,102,59,45,14,11,2,4,10,1,3,4,1,7,7,4,8
1,0022000679,1610612752,Knicks,NYK,New York,240.000000:00,106,49,34,15,12,0,15,33,4,3,7,6,8,14,7,14
0,0022000680,1610612746,Clippers,LAC,LA,240.000000:00,98,59,42,17,7,0,9,21,2,4,6,1,5,2,1,6
1,0022000680,1610612759,Spurs,SAS,San Antonio,240.000000:00,85,69,48,21,14,0,6,12,2,2,4,1,5,4,3,6
0,0022000681,1610612755,76ers,PHI,Philadelphia,240.000000:00,109,48,32,16,21,0,7,15,1,3,4,5,6,10,5,11
1,0022000681,1610612747,Lakers,LAL,Los Angeles,240.000000:00,101,47,17,30,11,1,7,14,6,4,10,2,11,12,9,13
0,0022000682,1610612744,Warriors,GSW,Golden State,240.000000:00,119,56,32,24,8,0,13,32,1,2,3,0,6,4,3,6
1,0022000682,1610612758,Kings,SAC,Sacramento,240.000000:00,141,56,30,26,9,0,5,10,0,3,3,1,14,11,5,15
0,0022000683,1610612751,Nets,BKN,Brooklyn,240.000000:00,113,47,33,14,12,2,11,23,2,1,3,3,14,13,2,17
1,0022000683,1610612765,Pistons,DET,Detroit,240.000000:00,111,41,23,18,11,0,9,20,5,5,10,3,10,11,5,13
0,0022000684,1610612756,Suns,PHX,Phoenix,240.000000:00,104,59,28,31,12,1,6,12,1,1,2,2,7,9,6,9
1,0022000684,1610612761,Raptors,TOR,Toronto,240.000000:00,100,56,29,27,10,1,11,25,7,2,9,3,16,14,11,19
0,0022000685,1610612738,Celtics,BOS,Boston,240.000000:00,122,55,32,23,22,2,10,25,4,4,8,0,5,5,0,5
1,0022000685,1610612749,Bucks,MIL,Milwaukee,240.000000:00,114,58,27,31,10,1,11,27,5,2,7,0,2,2,2,2
0,0022000686,1610612748,Heat,MIA,Miami,240.000000:00,105,43,15,28,17,1,2,5,3,9,12,1,4,5,3,5
1,0022000686,1610612766,Hornets,CHA,Charlotte,240.000000:00,110,50,23,27,11,1,7,17,2,3,5,2,5,7,7,7
0,0022000687,1610612757,Trail Blazers,POR,Portland,240.000000:00,112,69,52,17,6,0,10,23,3,2,5,4,3,7,5,7
1,0022000687,1610612753,Magic,ORL,Orlando,240.000000:00,105,54,27,27,16,2,12,26,2,2,4,0,3,2,2,3
0,0022000688,1610612745,Rockets,HOU,Houston,240.000000:00,101,56,38,18,14,0,5,12,4,2,6,5,14,14,5,19
1,0022000688,1610612750,Timberwolves,MIN,Minnesota,240.000000:00,107,56,29,27,22,0,7,16,5,1,6,1,7,6,3,8
0,0022000689,1610612743,Nuggets,DEN,Denver,240.000000:00,113,39,25,14,22,1,14,30,8,4,12,6,8,9,6,14
1,0022000689,1610612740,Pelicans,NOP,New Orleans,240.000000:00,108,62,46,16,16,0,8,16,2,3,5,2,7,9,5,9
0,0022000690,1610612754,Pacers,IND,Indiana,240.000000:00,109,63,37,26,15,1,11,27,4,3,7,3,3,6,5,6
1,0022000690,1610612742,Mavericks,DAL,Dallas,240.000000:00,94,58,27,31,11,2,9,20,6,2,8,1,14,12,9,15
0,0022000691,1610612763,Grizzlies,MEM,Memphis,240.000000:00,114,39,27,12,10,1,13,28,3,1,4,2,6,5,4,8
1,0022000691,1610612762,Jazz,UTA,Utah,240.000000:00,117,47,34,13,5,0,14,33,6,6,12,2,8,9,6,10
0,0022000692,1610612737,Hawks,ATL,Atlanta,240.000000:00,124,41,26,15,17,1,12,26,1,3,4,3,7,7,4,10
1,0022000692,1610612744,Warriors,GSW,Golden State,240.000000:00,108,53,33,20,16,0,12,28,1,1,2,0,14,7,1,14
0,0022000693,1610612739,Cavaliers,CLE,Cleveland,240.000000:00,86,36,22,14,14,0,9,18,3,1,4,3,12,6,4,15
1,0022000693,1610612747,Lakers,LAL,Los Angeles,240.000000:00,100,40,31,9,18,0,11,22,6,2,8,3,8,11,6,11
0,0022000694,1610612765,Pistons,DET,Detroit,240.000000:00,92,58,43,15,15,3,9,21,0,5,5,0,8,8,5,8
1,0022000694,1610612764,Wizards,WAS,Washington,240.000000:00,106,58,41,17,7,3,6,13,1,4,5,0,10,3,2,10
0,0022000695,1610612752,Knicks,NYK,New York,240.000000:00,102,58,32,26,18,2,9,21,2,3,5,3,9,8,3,12
1,0022000695,1610612749,Bucks,MIL,Milwaukee,240.000000:00,96,53,32,21,27,1,6,15,6,4,10,3,14,15,8,17
0,0022000696,1610612745,Rockets,HOU,Houston,240.000000:00,129,54,24,30,9,2,18,42,1,1,2,1,5,6,2,6
1,0022000696,1610612750,Timberwolves,MIN,Minnesota,240.000000:00,107,54,22,32,14,0,8,19,1,2,3,0,2,1,1,2
0,0022000697,1610612741,Bulls,CHI,Chicago,240.000000:00,104,55,41,14,12,0,5,10,2,2,4,1,7,7,4,8
1,0022000697,1610612759,Spurs,SAS,San Antonio,240.000000:00,120,53,29,24,16,2,19,43,3,1,4,0,6,6,0,6
0,0022000698,1610612742,Mavericks,DAL,Dallas,240.000000:00,103,63,44,19,6,1,13,29,4,4,8,2,6,6,4,8
1,0022000698,1610612740,Pelicans,NOP,New Orleans,240.000000:00,112,60,38,22,6,0,17,35,0,4,4,3,5,7,4,8
0,0022000699,1610612738,Celtics,BOS,Boston,240.000000:00,111,51,31,20,16,0,8,18,1,4,5,2,15,15,10,17
1,0022000699,1610612760,Thunder,OKC,Oklahoma City,240.000000:00,94,64,37,27,11,1,5,12,3,5,8,1,3,4,3,4
0,0022000700,1610612763,Grizzlies,MEM,Memphis,240.000000:00,110,43,24,19,18,0,10,21,2,3,5,3,10,11,9,13
1,0022000700,1610612762,Jazz,UTA,Utah,240.000000:00,126,56,36,20,13,1,9,24,0,1,1,1,14,9,7,15
0,0022000701,1610612755,76ers,PHI,Philadelphia,240.000000:00,112,35,22,13,13,0,10,21,2,5,7,1,4,5,2,5
1,0022000701,1610612746,Clippers,LAC,LA,240.000000:00,122,48,34,14,11,0,15,31,3,3,6,2,1,3,2,3
0,0022000702,1610612739,Cavaliers,CLE,Cleveland,240.000000:00,98,43,26,17,14,0,10,21,4,2,6,0,12,11,3,12
1,0022000702,1610612758,Kings,SAC,Sacramento,240.000000:00,100,48,36,12,13,0,12,24,2,2,4,2,2,4,3,4
0,0022000703,1610612756,Suns,PHX,Phoenix,265.000000:00,101,60,27,33,22,0,2,4,4,2,6,3,6,6,5,9
1,0022000703,1610612766,Hornets,CHA,Charlotte,265.000000:00,97,71,40,31,15,0,5,13,6,6,12,3,10,12,8,13
0,0022000704,1610612757,Trail Blazers,POR,Portland,240.000000:00,122,45,25,20,16,1,4,10,3,3,6,1,8,9,4,9
1,0022000704,1610612761,Raptors,TOR,Toronto,240.000000:00,117,55,31,24,8,0,10,25,3,0,3,2,16,13,2,18
0,0022000705,1610612737,Hawks,ATL,Atlanta,240.000000:00,102,53,26,27,8,0,8,19,1,2,3,0,10,9,6,10
1,0022000705,1610612743,Nuggets,DEN,Denver,240.000000:00,126,37,21,16,16,1,8,18,4,3,7,1,5,4,3,6
0,0022000706,1610612753,Magic,ORL,Orlando,240.000000:00,93,41,23,18,5,2,10,23,1,2,3,0,2,2,1,2
1,0022000706,1610612747,Lakers,LAL,Los Angeles,240.000000:00,96,47,30,17,14,0,7,16,2,6,8,0,8,8,6,8
0,0022000707,1610612754,Pacers,IND,Indiana,240.000000:00,124,51,40,11,21,0,7,14,6,2,8,0,11,11,4,11
1,0022000707,1610612764,Wizards,WAS,Washington,240.000000:00,132,48,34,14,12,1,9,19,4,1,5,2,12,14,7,14
0,0022000708,1610612740,Pelicans,NOP,New Orleans,240.000000:00,115,44,24,20,14,0,7,17,3,3,6,0,10,9,3,10
1,0022000708,1610612738,Celtics,BOS,Boston,240.000000:00,109,58,35,23,12,3,14,34,3,2,5,1,5,6,4,6
0,0022000709,1610612750,Timberwolves,MIN,Minnesota,240.000000:00,107,60,37,23,16,0,2,5,4,3,7,1,7,5,3,8
1,0022000709,1610612751,Nets,BKN,Brooklyn,240.000000:00,112,52,32,20,19,2,13,31,4,6,10,2,15,14,3,17
0,0022000710,1610612748,Heat,MIA,Miami,240.000000:00,98,54,31,23,15,1,6,15,6,6,12,3,12,13,9,15
1,0022000710,1610612752,Knicks,NYK,New York,240.000000:00,88,51,27,24,15,0,2,4,2,2,4,1,5,5,3,6
0,0022000711,1610612761,Raptors,TOR,Toronto,240.000000:00,104,44,28,16,8,0,6,13,3,5,8,0,1,1,0,1
1,0022000711,1610612765,Pistons,DET,Detroit,240.000000:00,118,51,26,25,11,1,5,13,3,2,5,0,0,0,0,0
0,0022000712,1610612763,Grizzlies,MEM,Memphis,240.000000:00,120,61,38,23,9,0,6,12,1,0,1,1,5,5,3,6
1,0022000712,1610612745,Rockets,HOU,Houston,240.000000:00,110,40,25,15,14,3,2,5,1,3,4,0,4,4,2,4
0,0022000713,1610612742,Mavericks,DAL,Dallas,240.000000:00,127,46,32,14,15,0,20,45,1,5,6,4,15,14,10,19
1,0022000713,1610612760,Thunder,OKC,Oklahoma City,240.000000:00,106,62,30,32,10,0,9,22,3,3,6,1,5,4,1,6
0,0022000714,1610612758,Kings,SAC,Sacramento,240.000000:00,132,59,39,20,18,0,13,30,2,3,5,1,8,5,3,9
1,0022000714,1610612759,Spurs,SAS,San Antonio,240.000000:00,115,58,32,26,9,0,13,29,7,5,12,1,4,5,3,5
0,0022000715,1610612739,Cavaliers,CLE,Cleveland,240.000000:00,75,47,25,22,11,0,10,20,3,2,5,2,19,13,7,21
1,0022000715,1610612762,Jazz,UTA,Utah,240.000000:00,114,56,32,24,8,0,9,24,3,1,4,3,13,13,10,16
0,0022000716,1610612741,Bulls,CHI,Chicago,240.000000:00,102,51,28,23,16,1,11,26,1,0,1,0,9,8,2,9
1,0022000716,1610612744,Warriors,GSW,Golden State,240.000000:00,116,49,37,12,14,1,17,43,2,2,4,1,7,8,2,8
0,0022000717,1610612749,Bucks,MIL,Milwaukee,240.000000:00,105,61,45,16,14,0,12,27,0,1,1,2,2,3,1,4
1,0022000717,1610612746,Clippers,LAC,LA,240.000000:00,129,45,32,13,6,2,12,27,3,0,3,0,6,3,1,6
0,0022000718,1610612766,Hornets,CHA,Charlotte,240.000000:00,114,55,32,23,12,0,14,33,2,0,2,1,8,9,4,9
1,0022000718,1610612764,Wizards,WAS,Washington,240.000000:00,104,51,34,17,11,0,4,9,5,1,6,1,8,8,4,9
0,0022000719,1610612755,76ers,PHI,Philadelphia,240.000000:00,95,41,23,18,25,0,9,20,0,4,4,0,8,8,5,8
1,0022000719,1610612743,Nuggets,DEN,Denver,240.000000:00,104,42,23,19,11,0,11,26,2,3,5,0,4,4,3,4
0,0022000720,1610612753,Magic,ORL,Orlando,240.000000:00,103,55,36,19,13,0,6,12,1,2,3,5,4,9,7,9
1,0022000720,1610612746,Clippers,LAC,LA,240.000000:00,96,59,51,8,6,0,9,20,2,1,3,5,4,9,6,9
0,0022000721,1610612757,Trail Blazers,POR,Portland,240.000000:00,124,28,17,11,23,0,12,30,1,2,3,3,8,9,2,11
1,0022000721,1610612765,Pistons,DET,Detroit,240.000000:00,101,46,27,19,8,1,4,9,0,4,4,0,7,6,1,7
0,0022000722,1610612748,Heat,MIA,Miami,240.000000:00,92,46,25,21,18,2,12,31,3,2,5,0,12,11,4,12
1,0022000722,1610612754,Pacers,IND,Indiana,240.000000:00,87,39,22,17,12,0,7,15,4,4,8,1,6,6,4,7
0,0022000723,1610612742,Mavericks,DAL,Dallas,240.000000:00,113,42,21,21,8,1,8,20,3,2,5,1,11,10,5,12
1,0022000723,1610612738,Celtics,BOS,Boston,240.000000:00,108,46,23,23,20,0,12,27,3,1,4,1,4,3,2,5
0,0022000724,1610612745,Rockets,HOU,Houston,240.000000:00,108,56,34,22,14,0,8,21,2,2,4,1,8,6,3,9
1,0022000724,1610612751,Nets,BKN,Brooklyn,240.000000:00,120,53,22,31,8,1,9,19,4,3,7,1,7,8,0,8
0,0022000725,1610612762,Jazz,UTA,Utah,240.000000:00,111,52,39,13,16,0,17,39,1,7,8,1,5,3,2,6
1,0022000725,1610612763,Grizzlies,MEM,Memphis,240.000000:00,107,45,19,26,12,1,21,43,3,2,5,3,5,7,4,8
0,0022000726,1610612752,Knicks,NYK,New York,240.000000:00,101,61,29,32,18,1,13,29,1,6,7,2,8,6,1,10
1,0022000726,1610612750,Timberwolves,MIN,Minnesota,240.000000:00,102,58,45,13,19,0,6,16,3,4,7,1,5,6,5,6
0,0022000727,1610612761,Raptors,TOR,Toronto,240.000000:00,103,62,40,22,29,1,16,41,2,3,5,0,23,14,1,23
1,0022000727,1610612760,Thunder,OKC,Oklahoma City,240.000000:00,113,69,34,35,7,0,6,14,4,2,6,0,12,12,4,12
0,0022000728,1610612758,Kings,SAC,Sacramento,240.000000:00,106,67,50,17,8,0,17,38,2,2,4,2,9,7,6,11
1,0022000728,1610612759,Spurs,SAS,San Antonio,240.000000:00,120,63,38,25,16,1,8,17,1,4,5,0,3,2,0,3
0,0022000729,1610612749,Bucks,MIL,Milwaukee,240.000000:00,112,66,39,27,16,3,10,25,7,5,12,2,4,5,2,6
1,0022000729,1610612747,Lakers,LAL,Los Angeles,240.000000:00,97,55,37,18,22,1,7,15,3,2,5,3,7,7,5,10
0,0022000730,1610612741,Bulls,CHI,Chicago,240.000000:00,116,51,34,17,6,0,6,13,0,1,1,5,5,10,7,10
1,0022000730,1610612756,Suns,PHX,Phoenix,240.000000:00,121,60,40,20,13,0,22,46,3,3,6,0,5,5,2,5
0,0022000731,1610612755,76ers,PHI,Philadelphia,240.000000:00,114,43,26,17,13,1,9,21,3,4,7,0,7,6,1,7
1,0022000731,1610612739,Cavaliers,CLE,Cleveland,240.000000:00,94,44,30,14,13,0,6,13,4,3,7,1,10,7,2,11
0,0022000732,1610612766,Hornets,CHA,Charlotte,240.000000:00,89,56,36,20,17,0,7,17,5,4,9,0,2,2,1,2
1,0022000732,1610612751,Nets,BKN,Brooklyn,240.000000:00,111,47,26,21,9,1,1,3,4,6,10,4,5,8,6,9
0,0022000733,1610612744,Warriors,GSW,Golden State,240.000000:00,109,44,27,17,13,1,7,18,5,1,6,1,4,5,2,5
1,0022000733,1610612748,Heat,MIA,Miami,240.000000:00,116,54,28,26,21,1,10,25,4,6,10,0,7,7,2,7
0,0022000734,1610612753,Magic,ORL,Orlando,265.000000:00,115,53,31,22,19,1,15,31,1,3,4,4,9,13,7,13
1,0022000734,1610612740,Pelicans,NOP,New Orleans,265.000000:00,110,66,47,19,17,0,10,21,2,2,4,1,2,3,1,3
0,0022000735,1610612737,Hawks,ATL,Atlanta,290.000000:00,134,60,36,24,9,0,20,45,1,2,3,0,14,7,4,14
1,0022000735,1610612759,Spurs,SAS,San Antonio,290.000000:00,129,43,31,12,17,1,14,33,2,0,2,1,18,12,6,20
0,0022000736,1610612743,Nuggets,DEN,Denver,240.000000:00,101,60,38,22,12,0,6,13,0,2,2,3,4,7,5,7
1,0022000736,1610612746,Clippers,LAC,LA,240.000000:00,94,56,38,18,13,0,10,23,2,1,3,0,4,3,1,4
0,0022000737,1610612744,Warriors,GSW,Golden State,240.000000:00,77,56,31,25,11,0,7,15,3,1,4,2,7,9,7,9
1,0022000737,1610612761,Raptors,TOR,Toronto,240.000000:00,130,56,29,27,19,0,12,26,1,3,4,0,11,9,5,11
0,0022000738,1610612745,Rockets,HOU,Houston,240.000000:00,102,42,23,19,7,0,6,16,2,0,2,1,3,3,2,4
1,0022000738,1610612738,Celtics,BOS,Boston,240.000000:00,118,54,31,23,16,0,12,30,3,1,4,1,5,6,2,6
0,0022000739,1610612742,Mavericks,DAL,Dallas,240.000000:00,99,55,33,22,7,0,13,31,1,2,3,1,12,7,1,13
1,0022000739,1610612752,Knicks,NYK,New York,240.000000:00,86,48,22,26,14,0,12,26,3,2,5,2,5,5,3,7
0,0022000740,1610612766,Hornets,CHA,Charlotte,240.000000:00,114,49,26,23,18,0,8,17,3,4,7,3,8,7,4,11
1,0022000740,1610612754,Pacers,IND,Indiana,240.000000:00,97,61,39,22,13,0,6,13,1,3,4,2,12,13,10,14
0,0022000741,1610612750,Timberwolves,MIN,Minnesota,240.000000:00,108,75,47,28,16,0,9,19,4,3,7,1,4,4,3,5
1,0022000741,1610612763,Grizzlies,MEM,Memphis,240.000000:00,120,59,34,25,18,0,10,24,3,2,5,0,1,0,0,1
0,0022000742,1610612737,Hawks,ATL,Atlanta,240.000000:00,126,47,35,12,25,1,19,44,5,5,10,0,11,7,4,11
1,0022000742,1610612740,Pelicans,NOP,New Orleans,240.000000:00,103,42,27,15,18,0,7,15,2,3,5,0,9,8,4,9
0,0022000743,1610612741,Bulls,CHI,Chicago,240.000000:00,106,43,23,20,11,0,9,21,3,4,7,1,4,5,4,5
1,0022000743,1610612762,Jazz,UTA,Utah,240.000000:00,113,49,31,18,13,0,10,25,3,4,7,1,3,3,2,4
0,0022000744,1610612760,Thunder,OKC,Oklahoma City,240.000000:00,103,52,27,25,9,1,2,4,1,1,2,3,2,5,4,5
1,0022000744,1610612756,Suns,PHX,Phoenix,240.000000:00,140,51,27,24,17,0,21,45,1,5,6,0,10,10,4,10
0,0022000745,1610612749,Bucks,MIL,Milwaukee,240.000000:00,127,65,29,36,13,0,12,28,1,3,4,2,2,4,2,4
1,0022000745,1610612757,Trail Blazers,POR,Portland,240.000000:00,109,42,18,24,18,0,8,20,3,5,8,4,2,6,5,6
0,0022000746,1610612747,Lakers,LAL,Los Angeles,240.000000:00,115,44,28,16,21,0,11,25,2,1,3,4,13,14,6,17
1,0022000746,1610612758,Kings,SAC,Sacramento,240.000000:00,94,56,41,15,15,0,8,18,1,3,4,1,14,10,2,15
0,0022000747,1610612742,Mavericks,DAL,Dallas,240.000000:00,109,47,35,12,15,1,14,30,2,1,3,2,6,6,6,8
1,0022000747,1610612764,Wizards,WAS,Washington,240.000000:00,87,51,32,19,12,0,12,26,3,1,4,3,10,12,5,13
0,0022000748,1610612752,Knicks,NYK,New York,240.000000:00,125,46,31,15,22,0,9,19,0,2,2,0,3,3,0,3
1,0022000748,1610612765,Pistons,DET,Detroit,240.000000:00,81,51,24,27,7,0,6,13,3,0,3,1,2,3,2,3
0,0022000749,1610612739,Cavaliers,CLE,Cleveland,240.000000:00,101,36,19,17,17,1,6,14,3,4,7,0,4,4,3,4
1,0022000749,1610612748,Heat,MIA,Miami,240.000000:00,115,36,21,15,11,1,7,18,3,3,6,0,8,6,5,8
0,0022000750,1610612750,Timberwolves,MIN,Minnesota,240.000000:00,113,52,35,17,13,2,9,22,5,4,9,0,5,5,2,5
1,0022000750,1610612755,76ers,PHI,Philadelphia,240.000000:00,122,39,24,15,15,0,7,17,2,2,4,1,9,7,3,10
0,0022000751,1610612754,Pacers,IND,Indiana,265.000000:00,139,53,37,16,17,0,13,27,3,3,6,2,9,7,3,11
1,0022000751,1610612759,Spurs,SAS,San Antonio,265.000000:00,133,62,45,17,14,0,14,29,7,2,9,7,6,11,7,13
0,0022000752,1610612753,Magic,ORL,Orlando,240.000000:00,91,40,10,30,13,0,14,31,1,3,4,0,5,4,0,5
1,0022000752,1610612762,Jazz,UTA,Utah,240.000000:00,137,45,30,15,15,0,12,29,1,4,5,0,11,10,3,11
0,0022000753,1610612760,Thunder,OKC,Oklahoma City,240.000000:00,85,68,35,33,13,0,7,16,3,3,6,2,5,7,4,7
1,0022000753,1610612757,Trail Blazers,POR,Portland,240.000000:00,133,40,18,22,19,0,9,22,4,7,11,11,8,15,14,19
0,0022000754,1610612749,Bucks,MIL,Milwaukee,240.000000:00,129,46,27,19,25,0,12,27,7,2,9,4,4,8,5,8
1,0022000754,1610612758,Kings,SAC,Sacramento,240.000000:00,128,53,35,18,21,0,16,40,6,0,6,3,6,8,3,9
0,0022000755,1610612751,Nets,BKN,Brooklyn,240.000000:00,107,52,36,16,8,1,13,28,5,2,7,1,7,7,2,8
1,0022000755,1610612741,Bulls,CHI,Chicago,240.000000:00,115,69,48,21,10,0,6,14,3,3,6,4,6,9,8,10
0,0022000756,1610612747,Lakers,LAL,Los Angeles,240.000000:00,86,61,45,16,17,2,6,13,0,2,2,2,7,9,3,9
1,0022000756,1610612746,Clippers,LAC,LA,240.000000:00,104,52,38,14,14,0,12,26,3,7,10,0,12,11,4,12
0,0022000757,1610612766,Hornets,CHA,Charlotte,240.000000:00,86,52,22,30,18,1,10,23,5,0,5,4,8,11,5,12
1,0022000757,1610612738,Celtics,BOS,Boston,240.000000:00,116,40,21,19,15,0,7,19,2,5,7,2,7,8,7,9
0,0022000758,1610612763,Grizzlies,MEM,Memphis,240.000000:00,116,53,33,20,15,0,16,39,3,2,5,2,4,6,4,6
1,0022000758,1610612755,76ers,PHI,Philadelphia,240.000000:00,100,45,25,20,12,0,11,24,2,2,4,2,2,3,3,4
0,0022000759,1610612744,Warriors,GSW,Golden State,240.000000:00,111,42,22,20,17,1,13,30,4,1,5,3,15,14,7,19
1,0022000759,1610612737,Hawks,ATL,Atlanta,240.000000:00,117,42,22,20,14,0,9,19,3,4,7,1,12,8,6,13
0,0022000760,1610612740,Pelicans,NOP,New Orleans,240.000000:00,122,64,36,28,14,0,7,20,1,2,3,4,5,9,6,9
1,0022000760,1610612745,Rockets,HOU,Houston,240.000000:00,115,52,35,17,5,2,8,20,1,1,2,1,7,7,4,8
0,0022000761,1610612753,Magic,ORL,Orlando,240.000000:00,109,40,26,14,13,0,10,24,3,2,5,0,2,1,0,2
1,0022000761,1610612743,Nuggets,DEN,Denver,240.000000:00,119,47,33,14,10,0,7,15,4,4,8,1,3,3,2,4
0,0022000762,1610612752,Knicks,NYK,New York,240.000000:00,112,70,48,22,11,0,9,21,1,3,4,0,15,8,5,15
1,0022000762,1610612751,Nets,BKN,Brooklyn,240.000000:00,114,60,37,23,12,1,10,23,2,2,4,5,9,11,4,14
0,0022000763,1610612764,Wizards,WAS,Washington,240.000000:00,101,58,35,23,17,3,5,14,3,5,8,1,8,9,7,9
1,0022000763,1610612761,Raptors,TOR,Toronto,240.000000:00,103,70,42,28,21,0,9,20,2,4,6,2,16,11,6,18
0,0022000764,1610612762,Jazz,UTA,Utah,240.000000:00,103,48,22,26,7,1,15,39,2,2,4,3,7,10,5,10
1,0022000764,1610612742,Mavericks,DAL,Dallas,240.000000:00,111,46,24,22,16,0,10,26,3,2,5,5,10,13,4,15
0,0022000765,1610612758,Kings,SAC,Sacramento,240.000000:00,106,47,29,18,13,0,5,11,3,4,7,1,10,11,2,11
1,0022000765,1610612750,Timberwolves,MIN,Minnesota,240.000000:00,116,44,26,18,20,0,10,23,4,3,7,1,8,8,3,9
0,0022000766,1610612765,Pistons,DET,Detroit,240.000000:00,132,47,33,14,16,0,16,34,3,4,7,2,5,6,4,7
1,0022000766,1610612760,Thunder,OKC,Oklahoma City,240.000000:00,108,58,40,18,16,1,9,18,0,2,2,2,6,6,4,8
0,0022000767,1610612739,Cavaliers,CLE,Cleveland,240.000000:00,125,48,31,17,12,1,13,27,3,1,4,1,4,5,2,5
1,0022000767,1610612759,Spurs,SAS,San Antonio,240.000000:00,101,42,25,17,21,0,11,23,3,2,5,1,5,6,3,6
0,0022000768,1610612756,Suns,PHX,Phoenix,240.000000:00,133,51,29,22,17,0,6,15,3,4,7,1,4,4,2,5
1,0022000768,1610612745,Rockets,HOU,Houston,240.000000:00,130,47,24,23,15,0,6,15,1,3,4,1,8,8,4,9
0,0022000769,1610612741,Bulls,CHI,Chicago,240.000000:00,113,60,39,21,13,0,10,23,3,1,4,2,8,9,4,10
1,0022000769,1610612754,Pacers,IND,Indiana,240.000000:00,97,60,40,20,26,1,12,26,3,5,8,1,10,10,3,11
0,0022000770,1610612740,Pelicans,NOP,New Orleans,240.000000:00,107,61,38,23,11,0,5,11,4,9,13,3,9,8,5,12
1,0022000770,1610612737,Hawks,ATL,Atlanta,240.000000:00,123,60,36,24,13,0,15,35,0,3,3,2,8,8,5,10
0,0022000771,1610612755,76ers,PHI,Philadelphia,240.000000:00,106,45,20,25,16,0,7,15,1,2,3,2,10,10,8,12
1,0022000771,1610612738,Celtics,BOS,Boston,240.000000:00,96,50,36,14,12,2,12,27,1,1,2,0,6,2,1,6
0,0022000772,1610612747,Lakers,LAL,Los Angeles,240.000000:00,110,58,36,22,14,0,8,18,3,3,6,0,7,5,1,7
1,0022000772,1610612761,Raptors,TOR,Toronto,240.000000:00,101,56,25,31,22,1,3,6,3,2,5,1,2,3,2,3
0,0022000773,1610612763,Grizzlies,MEM,Memphis,240.000000:00,124,42,21,21,24,0,10,23,2,5,7,3,5,6,4,8
1,0022000773,1610612748,Heat,MIA,Miami,240.000000:00,112,47,20,27,26,1,16,37,3,3,6,0,10,8,1,10
0,0022000774,1610612749,Bucks,MIL,Milwaukee,240.000000:00,121,61,38,23,18,0,15,35,3,2,5,1,3,4,3,4
1,0022000774,1610612744,Warriors,GSW,Golden State,240.000000:00,122,59,37,22,10,0,18,42,6,2,8,1,7,4,3,8
0,0022000775,1610612757,Trail Blazers,POR,Portland,240.000000:00,116,42,22,20,8,0,12,29,2,2,4,2,2,3,3,4
1,0022000775,1610612746,Clippers,LAC,LA,240.000000:00,133,59,32,27,16,0,19,44,0,2,2,2,8,8,3,10
0,0022000776,1610612750,Timberwolves,MIN,Minnesota,240.000000:00,137,69,48,21,11,1,6,14,5,2,7,0,4,3,1,4
1,0022000776,1610612754,Pacers,IND,Indiana,240.000000:00,141,57,39,18,13,0,9,18,1,1,2,1,4,2,1,5
0,0022000777,1610612764,Wizards,WAS,Washington,240.000000:00,131,58,45,13,12,0,11,27,1,3,4,1,9,9,1,10
1,0022000777,1610612753,Magic,ORL,Orlando,240.000000:00,116,58,35,23,21,1,18,39,3,2,5,2,10,7,3,12
0,0022000778,1610612752,Knicks,NYK,New York,240.000000:00,99,50,24,26,20,1,7,15,1,4,5,0,7,5,1,7
1,0022000778,1610612738,Celtics,BOS,Boston,240.000000:00,101,45,28,17,12,2,3,8,5,5,10,3,8,11,3,11
0,0022000779,1610612740,Pelicans,NOP,New Orleans,240.000000:00,111,50,27,23,16,1,11,22,3,1,4,3,2,5,4,5
1,0022000779,1610612751,Nets,BKN,Brooklyn,240.000000:00,139,64,46,18,13,1,9,23,5,7,12,0,16,11,3,16
0,0022000780,1610612763,Grizzlies,MEM,Memphis,240.000000:00,131,68,52,16,13,0,12,27,3,5,8,1,6,7,3,7
1,0022000780,1610612737,Hawks,ATL,Atlanta,240.000000:00,113,48,26,22,14,0,18,40,3,2,5,1,9,9,3,10
0,0022000781,1610612766,Hornets,CHA,Charlotte,240.000000:00,113,50,27,23,18,1,12,27,5,7,12,2,3,2,2,5
1,0022000781,1610612760,Thunder,OKC,Oklahoma City,240.000000:00,102,51,25,26,7,0,2,5,2,2,4,5,7,7,5,12
0,0022000782,1610612759,Spurs,SAS,San Antonio,240.000000:00,96,51,37,14,17,0,13,30,1,5,6,2,9,9,3,11
1,0022000782,1610612743,Nuggets,DEN,Denver,240.000000:00,106,55,38,17,12,0,6,13,3,1,4,0,4,4,0,4
0,0022000783,1610612762,Jazz,UTA,Utah,265.000000:00,113,51,34,17,16,0,13,29,4,0,4,3,16,13,6,19
1,0022000783,1610612756,Suns,PHX,Phoenix,265.000000:00,117,53,32,21,18,1,15,34,5,2,7,7,5,11,9,12
0,0022000784,1610612747,Lakers,LAL,Los Angeles,240.000000:00,104,40,21,19,16,1,7,17,2,2,4,3,3,6,4,6
1,0022000784,1610612748,Heat,MIA,Miami,240.000000:00,110,39,18,21,21,0,7,18,0,7,7,2,7,9,5,9
0,0022000785,1610612739,Cavaliers,CLE,Cleveland,240.000000:00,129,36,19,17,14,0,10,25,3,7,10,3,14,11,8,17
1,0022000785,1610612760,Thunder,OKC,Oklahoma City,240.000000:00,102,47,25,22,13,1,5,12,3,1,4,1,12,12,8,13
0,0022000786,1610612749,Bucks,MIL,Milwaukee,240.000000:00,101,77,41,36,13,0,7,18,3,4,7,2,2,2,2,4
1,0022000786,1610612742,Mavericks,DAL,Dallas,240.000000:00,116,72,50,22,7,0,5,14,3,3,6,4,5,8,4,9
0,0022000787,1610612757,Trail Blazers,POR,Portland,240.000000:00,103,40,22,18,13,0,12,27,1,0,1,0,4,3,1,4
1,0022000787,1610612762,Jazz,UTA,Utah,240.000000:00,122,45,20,25,11,0,13,31,2,1,3,1,10,8,6,11
0,0022000788,1610612756,Suns,PHX,Phoenix,240.000000:00,103,51,23,28,14,0,7,14,0,1,1,0,2,1,0,2
1,0022000788,1610612746,Clippers,LAC,LA,240.000000:00,113,27,14,13,13,0,9,23,6,1,7,2,6,5,2,8
0,0022000789,1610612765,Pistons,DET,Detroit,240.000000:00,113,57,32,25,12,0,16,36,2,4,6,1,8,9,4,9
1,0022000789,1610612758,Kings,SAC,Sacramento,240.000000:00,101,42,31,11,24,1,10,23,3,4,7,0,5,5,4,5
0,0022000790,1610612754,Pacers,IND,Indiana,240.000000:00,111,63,45,18,16,0,8,17,1,2,3,2,4,6,3,6
1,0022000790,1610612753,Magic,ORL,Orlando,240.000000:00,106,53,40,13,11,0,15,31,7,1,8,3,0,3,3,3
0,0022000791,1610612741,Bulls,CHI,Chicago,240.000000:00,108,44,24,20,13,0,13,33,1,2,3,0,7,7,2,7
1,0022000791,1610612737,Hawks,ATL,Atlanta,240.000000:00,120,49,28,21,13,0,20,43,3,0,3,0,5,5,2,5
0,0022000792,1610612750,Timberwolves,MIN,Minnesota,265.000000:00,136,58,30,28,19,0,7,15,3,3,6,0,7,5,3,7
1,0022000792,1610612738,Celtics,BOS,Boston,265.000000:00,145,64,36,28,14,1,14,33,3,5,8,3,12,11,5,15
0,0022000793,1610612763,Grizzlies,MEM,Memphis,265.000000:00,129,64,42,22,13,0,14,32,4,2,6,4,2,5,2,6
1,0022000793,1610612752,Knicks,NYK,New York,265.000000:00,133,41,25,16,15,1,19,42,5,4,9,1,6,5,3,7
0,0022000794,1610612761,Raptors,TOR,Toronto,240.000000:00,135,45,30,15,15,0,16,38,3,5,8,1,5,5,2,6
1,0022000794,1610612739,Cavaliers,CLE,Cleveland,240.000000:00,115,45,30,15,13,0,6,12,5,6,11,0,3,3,1,3
0,0022000795,1610612755,76ers,PHI,Philadelphia,240.000000:00,94,41,31,10,19,0,8,18,0,4,4,3,7,9,5,10
1,0022000795,1610612740,Pelicans,NOP,New Orleans,240.000000:00,101,48,25,23,15,0,4,8,5,7,12,2,8,10,5,10
0,0022000796,1610612766,Hornets,CHA,Charlotte,240.000000:00,127,62,38,24,11,0,0,0,2,4,6,1,5,6,6,6
1,0022000796,1610612749,Bucks,MIL,Milwaukee,240.000000:00,119,46,18,28,20,2,6,14,2,4,6,4,5,9,8,9
0,0022000797,1610612759,Spurs,SAS,San Antonio,240.000000:00,119,46,32,14,12,0,10,23,2,2,4,0,7,7,2,7
1,0022000797,1610612743,Nuggets,DEN,Denver,240.000000:00,121,51,35,16,13,1,11,24,2,1,3,3,3,5,3,6
0,0022000798,1610612764,Wizards,WAS,Washington,240.000000:00,110,51,29,22,10,0,6,12,3,0,3,2,17,18,7,19
1,0022000798,1610612744,Warriors,GSW,Golden State,240.000000:00,107,59,47,12,25,0,6,14,1,3,4,1,14,11,0,15
0,0022000799,1610612745,Rockets,HOU,Houston,240.000000:00,109,49,30,19,11,0,8,19,5,0,5,1,3,4,2,4
1,0022000799,1610612746,Clippers,LAC,LA,240.000000:00,126,48,23,25,22,1,10,21,2,3,5,2,7,9,3,9
0,0022000800,1610612747,Lakers,LAL,Los Angeles,240.000000:00,126,51,36,15,16,1,8,21,6,3,9,3,3,6,5,6
1,0022000800,1610612751,Nets,BKN,Brooklyn,240.000000:00,101,64,41,23,14,3,4,8,1,3,4,0,5,5,2,5
0,0022000801,1610612758,Kings,SAC,Sacramento,240.000000:00,112,56,26,30,12,0,13,32,4,3,7,1,8,9,7,9
1,0022000801,1610612762,Jazz,UTA,Utah,240.000000:00,128,47,25,22,8,0,2,6,2,4,6,2,6,6,4,8
0,0022000802,1610612745,Rockets,HOU,Houston,240.000000:00,109,41,27,14,11,0,7,18,3,0,3,4,3,6,6,7
1,0022000802,1610612744,Warriors,GSW,Golden State,240.000000:00,125,43,22,21,13,0,11,27,6,3,9,0,19,11,4,19
0,0022000803,1610612764,Wizards,WAS,Washington,240.000000:00,106,70,38,32,8,0,3,7,2,2,4,2,1,3,2,3
1,0022000803,1610612756,Suns,PHX,Phoenix,240.000000:00,134,45,28,17,17,0,16,37,1,1,2,0,5,5,1,5
0,0022000804,1610612765,Pistons,DET,Detroit,240.000000:00,103,51,33,18,11,0,5,12,3,2,5,1,6,4,3,7
1,0022000804,1610612757,Trail Blazers,POR,Portland,240.000000:00,118,37,24,13,12,0,15,36,4,1,5,8,2,9,7,10
0,0022000805,1610612737,Hawks,ATL,Atlanta,240.000000:00,105,52,23,29,11,1,5,12,1,5,6,0,2,2,0,2
1,0022000805,1610612766,Hornets,CHA,Charlotte,240.000000:00,101,42,24,18,12,1,5,11,3,1,4,0,8,7,4,8
0,0022000806,1610612738,Celtics,BOS,Boston,240.000000:00,105,58,36,22,9,1,10,21,3,4,7,0,8,7,2,8
1,0022000806,1610612743,Nuggets,DEN,Denver,240.000000:00,87,47,25,22,17,0,2,5,3,2,5,0,4,3,1,4
0,0022000807,1610612740,Pelicans,NOP,New Orleans,240.000000:00,116,47,23,24,15,1,2,4,3,5,8,1,12,10,8,13
1,0022000807,1610612739,Cavaliers,CLE,Cleveland,240.000000:00,109,44,29,15,10,3,12,29,6,5,11,1,5,6,2,6
0,0022000808,1610612749,Bucks,MIL,Milwaukee,240.000000:00,124,39,21,18,16,0,10,23,5,2,7,1,7,8,4,8
1,0022000808,1610612753,Magic,ORL,Orlando,240.000000:00,87,52,31,21,13,0,12,25,2,2,4,1,2,2,1,3
0,0022000809,1610612761,Raptors,TOR,Toronto,240.000000:00,96,58,35,23,12,0,4,10,1,2,3,1,6,7,2,7
1,0022000809,1610612752,Knicks,NYK,New York,240.000000:00,102,50,33,17,14,0,9,21,7,3,10,2,7,9,7,9
0,0022000810,1610612759,Spurs,SAS,San Antonio,240.000000:00,119,56,28,28,16,0,20,43,1,3,4,0,4,4,0,4
1,0022000810,1610612742,Mavericks,DAL,Dallas,240.000000:00,117,46,34,12,8,0,11,25,2,3,5,0,2,2,1,2
0,0022000811,1610612754,Pacers,IND,Indiana,240.000000:00,132,60,51,9,9,0,8,17,2,2,4,6,6,10,8,12
1,0022000811,1610612763,Grizzlies,MEM,Memphis,240.000000:00,125,54,31,23,24,0,9,18,1,4,5,8,9,15,12,17
0,0022000812,1610612741,Bulls,CHI,Chicago,240.000000:00,117,52,28,24,16,1,12,26,1,1,2,4,3,4,3,7
1,0022000812,1610612750,Timberwolves,MIN,Minnesota,240.000000:00,121,56,29,27,13,0,13,29,2,4,6,0,10,8,5,10
0,0022000813,1610612765,Pistons,DET,Detroit,240.000000:00,124,47,32,15,11,0,17,40,9,4,13,1,4,5,2,5
1,0022000813,1610612746,Clippers,LAC,LA,240.000000:00,131,48,33,15,12,0,17,36,3,2,5,2,10,6,2,12
0,0022000814,1610612748,Heat,MIA,Miami,240.000000:00,107,39,19,20,21,2,12,29,4,3,7,0,10,7,1,10
1,0022000814,1610612757,Trail Blazers,POR,Portland,240.000000:00,98,44,27,17,16,0,8,18,3,3,6,1,6,7,1,7
0,0022000815,1610612747,Lakers,LAL,Los Angeles,240.000000:00,96,49,37,12,12,2,8,18,2,2,4,1,7,7,5,8
1,0022000815,1610612752,Knicks,NYK,New York,240.000000:00,111,47,26,21,24,0,9,19,6,3,9,4,9,12,8,13
0,0022000816,1610612759,Spurs,SAS,San Antonio,240.000000:00,120,48,36,12,14,1,15,33,1,3,4,2,5,7,4,7
1,0022000816,1610612753,Magic,ORL,Orlando,240.000000:00,97,49,36,13,10,1,11,24,3,2,5,1,4,5,2,5
0,0022000817,1610612751,Nets,BKN,Brooklyn,240.000000:00,127,60,30,30,11,0,12,31,2,2,4,3,9,12,8,12
1,0022000817,1610612750,Timberwolves,MIN,Minnesota,240.000000:00,97,52,32,20,19,1,5,13,1,5,6,2,6,6,4,8
0,0022000818,1610612755,76ers,PHI,Philadelphia,240.000000:00,113,49,26,23,12,1,7,16,1,3,4,1,9,9,4,10
1,0022000818,1610612742,Mavericks,DAL,Dallas,240.000000:00,95,53,34,19,7,0,11,23,4,4,8,0,7,6,2,7
0,0022000819,1610612758,Kings,SAC,Sacramento,240.000000:00,110,45,33,12,17,0,8,18,0,2,2,0,3,3,1,3
1,0022000819,1610612740,Pelicans,NOP,New Orleans,240.000000:00,117,53,33,20,12,0,6,13,3,4,7,3,2,3,2,5
0,0022000820,1610612764,Wizards,WAS,Washington,240.000000:00,125,47,33,14,13,2,15,32,1,4,5,0,21,17,3,21
1,0022000820,1610612762,Jazz,UTA,Utah,240.000000:00,121,57,45,12,10,1,19,46,2,1,3,4,20,19,8,24
0,0022000821,1610612743,Nuggets,DEN,Denver,240.000000:00,107,46,16,30,19,1,12,26,2,2,4,0,4,4,3,4
1,0022000821,1610612744,Warriors,GSW,Golden State,240.000000:00,116,56,36,20,18,1,12,29,2,3,5,0,7,7,2,7
0,0022000822,1610612745,Rockets,HOU,Houston,240.000000:00,120,45,18,27,17,0,5,13,3,4,7,1,17,15,11,18
1,0022000822,1610612756,Suns,PHX,Phoenix,240.000000:00,126,47,19,28,16,0,6,15,2,2,4,1,15,11,6,16
0,0022000823,1610612746,Clippers,LAC,LA,240.000000:00,126,62,34,28,18,0,8,19,3,1,4,1,4,3,2,5
1,0022000823,1610612754,Pacers,IND,Indiana,240.000000:00,115,49,29,20,17,0,9,19,2,2,4,1,5,5,1,6
0,0022000824,1610612737,Hawks,ATL,Atlanta,240.000000:00,108,53,24,29,11,0,11,24,3,3,6,0,11,10,4,11
1,0022000824,1610612761,Raptors,TOR,Toronto,240.000000:00,103,53,32,21,15,1,11,24,5,2,7,4,13,11,6,17
0,0022000825,1610612747,Lakers,LAL,Los Angeles,240.000000:00,101,45,22,23,12,2,4,8,4,5,9,3,9,10,3,12
1,0022000825,1610612766,Hornets,CHA,Charlotte,240.000000:00,93,37,20,17,15,1,7,17,6,2,8,2,5,7,3,7
0,0022000826,1610612760,Thunder,OKC,Oklahoma City,240.000000:00,96,54,21,33,10,0,20,46,3,1,4,1,5,6,3,6
1,0022000826,1610612762,Jazz,UTA,Utah,240.000000:00,106,61,37,24,15,1,11,26,2,2,4,0,5,5,4,5
0,0022000827,1610612748,Heat,MIA,Miami,240.000000:00,86,36,17,19,16,1,12,31,4,3,7,2,3,5,3,5
1,0022000827,1610612756,Suns,PHX,Phoenix,240.000000:00,106,40,20,20,17,1,5,11,6,3,9,4,5,9,5,9
0,0022000828,1610612738,Celtics,BOS,Boston,240.000000:00,116,64,38,26,15,1,13,31,2,4,6,1,8,9,7,9
1,0022000828,1610612757,Trail Blazers,POR,Portland,240.000000:00,115,52,33,19,11,0,14,37,1,3,4,2,7,9,5,9
0,0022000829,1610612739,Cavaliers,CLE,Cleveland,240.000000:00,103,55,26,29,19,0,4,9,2,3,5,1,6,6,4,7
1,0022000829,1610612766,Hornets,CHA,Charlotte,240.000000:00,90,39,21,18,16,1,6,15,4,2,6,0,12,6,4,12
0,0022000830,1610612751,Nets,BKN,Brooklyn,240.000000:00,117,47,34,13,14,1,14,31,1,1,2,1,1,1,1,2
1,0022000830,1610612755,76ers,PHI,Philadelphia,240.000000:00,123,48,33,15,15,0,8,17,1,2,3,0,6,6,1,6
0,0022000831,1610612759,Spurs,SAS,San Antonio,240.000000:00,112,52,29,23,15,1,7,18,3,3,6,0,10,9,3,10
1,0022000831,1610612761,Raptors,TOR,Toronto,240.000000:00,117,57,28,29,12,0,9,21,1,3,4,4,7,10,6,11
0,0022000832,1610612746,Clippers,LAC,LA,240.000000:00,100,60,43,17,13,2,13,28,4,3,7,1,7,7,4,8
1,0022000832,1610612765,Pistons,DET,Detroit,240.000000:00,98,68,45,23,13,1,10,21,4,1,5,0,12,9,6,12
0,0022000833,1610612753,Magic,ORL,Orlando,240.000000:00,115,50,30,20,13,1,8,16,8,2,10,2,3,5,4,5
1,0022000833,1610612741,Bulls,CHI,Chicago,240.000000:00,106,58,39,19,11,0,6,16,4,1,5,0,5,4,0,5
0,0022000834,1610612749,Bucks,MIL,Milwaukee,240.000000:00,130,61,33,28,20,0,9,23,4,5,9,1,4,4,2,5
1,0022000834,1610612750,Timberwolves,MIN,Minnesota,240.000000:00,105,82,48,34,19,0,7,19,6,6,12,1,5,2,1,6
0,0022000835,1610612752,Knicks,NYK,New York,240.000000:00,116,49,31,18,11,0,16,36,2,1,3,1,5,6,3,6
1,0022000835,1610612740,Pelicans,NOP,New Orleans,240.000000:00,106,65,40,25,6,1,6,13,3,3,6,1,6,7,2,7
0,0022000836,1610612744,Warriors,GSW,Golden State,240.000000:00,147,46,32,14,22,1,18,47,0,3,3,0,18,14,4,18
1,0022000836,1610612760,Thunder,OKC,Oklahoma City,240.000000:00,109,47,19,28,9,0,2,5,4,4,8,4,2,6,3,6
0,0022000837,1610612742,Mavericks,DAL,Dallas,240.000000:00,114,52,31,21,7,0,13,30,3,2,5,2,9,8,3,11
1,0022000837,1610612763,Grizzlies,MEM,Memphis,240.000000:00,113,57,32,25,14,0,15,36,0,2,2,4,12,16,10,16
0,0022000838,1610612748,Heat,MIA,Miami,240.000000:00,106,52,33,19,19,1,8,21,1,2,3,0,4,3,1,4
1,0022000838,1610612743,Nuggets,DEN,Denver,240.000000:00,123,40,21,19,9,0,9,20,4,2,6,2,2,4,3,4
0,0022000839,1610612764,Wizards,WAS,Washington,240.000000:00,123,49,35,14,17,2,9,20,5,5,10,4,11,14,8,15
1,0022000839,1610612758,Kings,SAC,Sacramento,240.000000:00,111,52,37,15,17,0,7,15,2,8,10,1,3,3,2,4
0,0022000840,1610612749,Bucks,MIL,Milwaukee,240.000000:00,120,46,28,18,13,0,11,27,4,2,6,0,10,10,5,10
1,0022000840,1610612737,Hawks,ATL,Atlanta,240.000000:00,109,55,27,28,15,0,10,20,1,1,2,3,6,9,4,9
0,0022000841,1610612744,Warriors,GSW,Golden State,240.000000:00,119,47,28,19,11,0,9,22,3,1,4,2,4,6,3,6
1,0022000841,1610612739,Cavaliers,CLE,Cleveland,240.000000:00,101,49,25,24,15,0,7,16,2,2,4,0,2,2,2,2
0,0022000842,1610612738,Celtics,BOS,Boston,240.000000:00,121,56,38,18,17,2,15,32,1,1,2,2,10,12,5,12
1,0022000842,1610612747,Lakers,LAL,Los Angeles,240.000000:00,113,41,26,15,17,0,13,29,3,4,7,1,4,3,1,5
0,0022000843,1610612758,Kings,SAC,Sacramento,240.000000:00,114,56,29,27,11,1,11,25,3,1,4,3,4,7,5,7
1,0022000843,1610612756,Suns,PHX,Phoenix,240.000000:00,122,53,35,18,8,1,12,26,3,3,6,3,0,2,2,3
0,0022000844,1610612754,Pacers,IND,Indiana,240.000000:00,111,49,23,26,15,0,7,18,3,2,5,2,15,17,6,17
1,0022000844,1610612762,Jazz,UTA,Utah,240.000000:00,119,67,44,23,11,1,16,39,4,0,4,3,9,7,1,12
0,0022000845,1610612760,Thunder,OKC,Oklahoma City,240.000000:00,104,64,35,29,24,0,11,24,3,6,9,1,16,7,6,17
1,0022000845,1610612765,Pistons,DET,Detroit,240.000000:00,110,56,36,20,17,0,13,31,5,3,8,3,9,10,5,12
0,0022000846,1610612746,Clippers,LAC,LA,240.000000:00,103,52,26,26,14,2,6,13,5,2,7,1,5,1,1,6
1,0022000846,1610612755,76ers,PHI,Philadelphia,240.000000:00,106,58,28,30,24,1,6,15,3,4,7,2,4,6,3,6
0,0022000847,1610612740,Pelicans,NOP,New Orleans,265.000000:00,115,54,41,13,19,0,8,18,2,3,5,0,4,4,3,4
1,0022000847,1610612764,Wizards,WAS,Washington,265.000000:00,117,58,41,17,10,0,11,22,2,1,3,0,6,6,1,6
0,0022000848,1610612766,Hornets,CHA,Charlotte,240.000000:00,115,44,20,24,15,0,7,15,5,3,8,1,5,5,3,6
1,0022000848,1610612751,Nets,BKN,Brooklyn,240.000000:00,130,49,28,21,15,2,7,21,3,4,7,0,7,7,4,7
0,0022000849,1610612753,Magic,ORL,Orlando,240.000000:00,102,48,26,22,16,1,9,20,1,4,5,2,3,3,3,5
1,0022000849,1610612761,Raptors,TOR,Toronto,240.000000:00,113,45,32,13,15,0,8,17,1,5,6,0,2,2,2,2
0,0022000850,1610612763,Grizzlies,MEM,Memphis,240.000000:00,126,66,42,24,7,1,12,28,3,2,5,1,10,10,5,11
1,0022000850,1610612741,Bulls,CHI,Chicago,240.000000:00,115,55,25,30,13,1,11,26,3,3,6,2,7,8,5,9
0,0022000851,1610612743,Nuggets,DEN,Denver,240.000000:00,128,36,23,13,14,0,7,15,4,0,4,2,2,3,2,4
1,0022000851,1610612745,Rockets,HOU,Houston,240.000000:00,99,49,28,21,10,1,1,3,1,2,3,0,6,5,2,6
0,0022000852,1610612748,Heat,MIA,Miami,240.000000:00,111,52,28,24,21,1,10,24,4,2,6,0,6,4,2,6
1,0022000852,1610612750,Timberwolves,MIN,Minnesota,240.000000:00,119,42,25,17,9,0,3,8,5,2,7,1,8,8,6,9
0,0022000853,1610612757,Trail Blazers,POR,Portland,240.000000:00,107,59,41,18,13,0,13,29,2,4,6,1,4,2,1,5
1,0022000853,1610612759,Spurs,SAS,San Antonio,240.000000:00,106,57,37,20,13,0,6,12,1,1,2,1,3,4,2,4
0,0022000854,1610612752,Knicks,NYK,New York,240.000000:00,117,44,26,18,8,0,14,30,4,2,6,0,4,3,0,4
1,0022000854,1610612742,Mavericks,DAL,Dallas,240.000000:00,109,54,42,12,14,0,15,37,3,3,6,2,9,10,4,11
0,0022000855,1610612762,Jazz,UTA,Utah,265.000000:00,115,52,35,17,16,0,7,18,3,3,6,1,11,9,0,12
1,0022000855,1610612747,Lakers,LAL,Los Angeles,265.000000:00,127,69,30,39,18,0,10,21,3,4,7,1,14,12,6,15
0,0022000856,1610612765,Pistons,DET,Detroit,240.000000:00,100,64,51,13,18,1,11,24,3,2,5,0,15,12,4,15
1,0022000856,1610612764,Wizards,WAS,Washington,240.000000:00,121,49,35,14,15,2,13,27,4,2,6,2,12,11,4,14
0,0022000857,1610612739,Cavaliers,CLE,Cleveland,240.000000:00,96,55,31,24,12,0,8,19,4,2,6,2,4,5,3,6
1,0022000857,1610612741,Bulls,CHI,Chicago,240.000000:00,106,57,34,23,10,0,8,17,3,3,6,1,3,4,2,4
0,0022000858,1610612744,Warriors,GSW,Golden State,240.000000:00,114,48,22,26,9,1,14,34,2,0,2,0,8,8,2,8
1,0022000858,1610612738,Celtics,BOS,Boston,240.000000:00,119,40,14,26,13,1,12,27,0,2,2,1,6,7,5,7
0,0022000859,1610612763,Grizzlies,MEM,Memphis,240.000000:00,128,54,24,30,14,0,12,27,1,2,3,3,4,7,6,7
1,0022000859,1610612749,Bucks,MIL,Milwaukee,240.000000:00,115,58,33,25,6,0,10,22,9,2,11,4,7,11,7,11
0,0022000860,1610612759,Spurs,SAS,San Antonio,240.000000:00,111,55,36,19,16,0,16,35,2,1,3,1,6,7,6,7
1,0022000860,1610612756,Suns,PHX,Phoenix,240.000000:00,85,51,36,15,12,1,15,30,6,1,7,4,3,7,4,7
0,0022000861,1610612754,Pacers,IND,Indiana,240.000000:00,117,56,37,19,12,0,11,25,3,5,8,1,11,11,3,12
1,0022000861,1610612737,Hawks,ATL,Atlanta,240.000000:00,129,52,34,18,18,1,11,25,3,0,3,1,7,8,4,8
0,0022000862,1610612740,Pelicans,NOP,New Orleans,265.000000:00,112,46,34,12,15,2,11,22,6,4,10,6,5,10,6,11
1,0022000862,1610612752,Knicks,NYK,New York,265.000000:00,122,42,30,12,16,0,8,17,1,1,2,2,11,13,6,13
0,0022000863,1610612751,Nets,BKN,Brooklyn,240.000000:00,107,48,23,25,14,0,9,26,2,1,3,0,3,3,1,3
1,0022000863,1610612748,Heat,MIA,Miami,240.000000:00,109,57,25,32,16,0,8,21,3,5,8,0,8,8,2,8
0,0022000864,1610612745,Rockets,HOU,Houston,240.000000:00,114,50,33,17,11,0,6,17,5,4,9,1,6,4,3,7
1,0022000864,1610612753,Magic,ORL,Orlando,240.000000:00,110,42,20,22,16,0,10,23,3,6,9,2,3,4,2,5
0,0022000865,1610612760,Thunder,OKC,Oklahoma City,240.000000:00,106,64,37,27,13,1,6,12,6,6,12,2,4,6,4,6
1,0022000865,1610612761,Raptors,TOR,Toronto,240.000000:00,112,44,24,20,16,0,10,21,3,4,7,2,4,4,1,6
0,0022000866,1610612758,Kings,SAC,Sacramento,240.000000:00,121,58,29,29,16,1,5,12,3,4,7,5,4,6,5,9
1,0022000866,1610612742,Mavericks,DAL,Dallas,240.000000:00,107,62,47,15,9,0,12,28,3,2,5,1,3,2,1,4
0,0022000867,1610612750,Timberwolves,MIN,Minnesota,240.000000:00,105,46,26,20,16,1,7,18,2,3,5,2,2,4,1,4
1,0022000867,1610612746,Clippers,LAC,LA,240.000000:00,124,53,23,30,8,0,9,21,4,2,6,2,9,11,6,11
0,0022000868,1610612739,Cavaliers,CLE,Cleveland,240.000000:00,105,50,33,17,15,0,12,25,6,6,12,1,14,11,7,15
1,0022000868,1610612765,Pistons,DET,Detroit,240.000000:00,109,47,30,17,18,0,9,19,3,1,4,1,11,10,7,12
0,0022000869,1610612741,Bulls,CHI,Chicago,240.000000:00,102,48,34,14,16,0,4,8,4,3,7,1,7,8,5,8
1,0022000869,1610612738,Celtics,BOS,Boston,240.000000:00,96,60,41,19,16,1,9,19,1,3,4,1,0,1,0,1
0,0022000870,1610612744,Warriors,GSW,Golden State,240.000000:00,107,45,32,13,9,1,12,33,2,1,3,1,3,4,4,4
1,0022000870,1610612755,76ers,PHI,Philadelphia,240.000000:00,96,31,19,12,14,0,11,23,3,1,4,1,4,3,1,5
0,0022000871,1610612745,Rockets,HOU,Houston,240.000000:00,91,56,27,29,18,0,4,10,3,3,6,0,4,4,1,4
1,0022000871,1610612748,Heat,MIA,Miami,240.000000:00,113,50,26,24,13,0,13,32,4,3,7,1,4,5,2,5
0,0022000872,1610612760,Thunder,OKC,Oklahoma City,240.000000:00,107,55,37,18,16,1,11,28,1,3,4,1,10,11,5,11
1,0022000872,1610612764,Wizards,WAS,Washington,240.000000:00,119,44,33,11,16,1,9,20,4,4,8,3,10,12,5,13
0,0022000873,1610612756,Suns,PHX,Phoenix,265.000000:00,128,71,48,23,15,0,18,39,4,2,6,1,12,5,3,13
1,0022000873,1610612749,Bucks,MIL,Milwaukee,265.000000:00,127,80,46,34,16,0,9,22,1,3,4,0,9,8,3,9
0,0022000874,1610612763,Grizzlies,MEM,Memphis,290.000000:00,137,63,39,24,20,0,10,23,1,7,8,0,18,16,4,18
1,0022000874,1610612743,Nuggets,DEN,Denver,290.000000:00,139,58,31,27,16,0,9,21,2,1,3,5,3,8,5,8
0,0022000875,1610612762,Jazz,UTA,Utah,240.000000:00,111,41,30,11,11,1,11,26,2,2,4,1,0,1,1,1
1,0022000875,1610612747,Lakers,LAL,Los Angeles,240.000000:00,97,37,21,16,18,0,12,27,2,7,9,2,7,9,4,9
0,0022000876,1610612753,Magic,ORL,Orlando,240.000000:00,96,47,24,23,18,0,6,13,4,7,11,1,12,11,5,13
1,0022000876,1610612737,Hawks,ATL,Atlanta,240.000000:00,112,51,29,22,12,0,17,39,2,1,3,0,13,13,1,13
0,0022000877,1610612766,Hornets,CHA,Charlotte,240.000000:00,97,51,24,27,27,1,10,24,3,4,7,2,2,4,3,4
1,0022000877,1610612752,Knicks,NYK,New York,240.000000:00,109,60,34,26,11,0,9,20,4,1,5,3,8,11,6,11
0,0022000878,1610612751,Nets,BKN,Brooklyn,240.000000:00,134,55,31,24,14,1,15,34,2,1,3,1,7,8,2,8
1,0022000878,1610612740,Pelicans,NOP,New Orleans,240.000000:00,129,55,32,23,9,0,19,42,1,3,4,1,5,6,3,6
0,0022000879,1610612746,Clippers,LAC,LA,240.000000:00,113,57,28,29,7,0,12,27,2,2,4,5,11,14,10,16
1,0022000879,1610612757,Trail Blazers,POR,Portland,240.000000:00,112,43,21,22,12,0,15,35,6,4,10,3,8,8,7,11
0,0022000880,1610612750,Timberwolves,MIN,Minnesota,240.000000:00,134,69,40,29,19,0,9,19,4,3,7,2,2,4,4,4
1,0022000880,1610612758,Kings,SAC,Sacramento,240.000000:00,120,49,24,25,20,1,7,19,1,2,3,0,5,4,4,5
0,0022000881,1610612741,Bulls,CHI,Chicago,240.000000:00,105,45,27,18,15,0,9,19,3,0,3,2,5,7,4,7
1,0022000881,1610612739,Cavaliers,CLE,Cleveland,240.000000:00,121,36,17,19,14,0,13,30,1,3,4,4,2,6,5,6
0,0022000882,1610612760,Thunder,OKC,Oklahoma City,240.000000:00,116,59,33,26,18,0,6,14,3,3,6,7,8,13,7,15
1,0022000882,1610612754,Pacers,IND,Indiana,240.000000:00,122,41,26,15,20,0,7,15,6,4,10,2,11,12,4,13
0,0022000883,1610612756,Suns,PHX,Phoenix,240.000000:00,116,48,37,11,15,0,18,39,1,2,3,1,6,7,3,7
1,0022000883,1610612755,76ers,PHI,Philadelphia,240.000000:00,113,46,21,25,18,0,6,15,2,3,5,5,9,13,7,14
0,0022000884,1610612751,Nets,BKN,Brooklyn,240.000000:00,103,60,33,27,13,2,6,17,2,3,5,3,22,21,3,25
1,0022000884,1610612761,Raptors,TOR,Toronto,240.000000:00,114,71,42,29,15,0,6,15,3,2,5,0,14,10,3,14
0,0022000885,1610612744,Warriors,GSW,Golden State,240.000000:00,114,50,33,17,21,1,11,28,2,4,6,1,11,8,4,12
1,0022000885,1610612764,Wizards,WAS,Washington,240.000000:00,118,61,36,25,18,0,7,15,5,6,11,1,4,4,2,5
0,0022000886,1610612737,Hawks,ATL,Atlanta,265.000000:00,127,59,37,22,19,1,14,30,1,2,3,1,9,8,3,10
1,0022000886,1610612752,Knicks,NYK,New York,265.000000:00,137,45,29,16,13,0,19,44,1,3,4,1,15,16,4,16
0,0022000887,1610612762,Jazz,UTA,Utah,240.000000:00,112,57,26,31,9,1,4,9,3,3,6,3,6,7,3,9
1,0022000887,1610612745,Rockets,HOU,Houston,240.000000:00,89,59,27,32,8,0,7,19,3,4,7,0,6,3,1,6
0,0022000888,1610612748,Heat,MIA,Miami,240.000000:00,107,42,27,15,10,0,8,21,4,1,5,2,12,11,5,14
1,0022000888,1610612759,Spurs,SAS,San Antonio,240.000000:00,87,47,31,16,3,1,5,11,5,1,6,0,5,4,1,5
0,0022000889,1610612763,Grizzlies,MEM,Memphis,240.000000:00,105,53,39,14,10,1,9,18,2,1,3,0,10,9,2,10
1,0022000889,1610612746,Clippers,LAC,LA,240.000000:00,117,39,25,14,9,3,16,37,0,2,2,2,6,5,3,8
0,0022000890,1610612743,Nuggets,DEN,Denver,240.000000:00,106,50,27,23,8,0,9,21,2,4,6,0,1,1,0,1
1,0022000890,1610612757,Trail Blazers,POR,Portland,240.000000:00,105,51,23,28,10,0,8,19,0,2,2,1,2,2,1,3
0,0022000891,1610612750,Timberwolves,MIN,Minnesota,240.000000:00,125,40,21,19,13,0,13,32,3,0,3,1,3,4,1,4
1,0022000891,1610612758,Kings,SAC,Sacramento,240.000000:00,128,49,33,16,15,0,9,21,4,2,6,2,5,6,2,7
0,0022000892,1610612756,Suns,PHX,Phoenix,240.000000:00,86,44,20,24,20,0,8,17,1,3,4,0,6,6,2,6
1,0022000892,1610612738,Celtics,BOS,Boston,240.000000:00,99,55,30,25,10,3,10,24,6,4,10,0,9,9,1,9
0,0022000893,1610612740,Pelicans,NOP,New Orleans,240.000000:00,135,56,30,26,7,0,9,19,1,0,1,6,6,12,10,12
1,0022000893,1610612753,Magic,ORL,Orlando,240.000000:00,100,36,19,17,13,1,12,28,3,2,5,1,4,5,5,5
0,0022000894,1610612755,76ers,PHI,Philadelphia,240.000000:00,117,42,19,23,13,0,11,23,3,3,6,1,10,8,4,11
1,0022000894,1610612749,Bucks,MIL,Milwaukee,240.000000:00,124,66,49,17,13,0,13,32,4,2,6,0,2,2,1,2
0,0022000895,1610612765,Pistons,DET,Detroit,240.000000:00,91,50,34,16,7,2,12,28,4,2,6,1,8,8,5,9
1,0022000895,1610612759,Spurs,SAS,San Antonio,240.000000:00,106,43,31,12,22,0,9,19,6,5,11,2,7,7,5,9
0,0022000896,1610612766,Hornets,CHA,Charlotte,240.000000:00,91,47,23,24,14,0,11,23,3,5,8,1,3,3,1,4
1,0022000896,1610612741,Bulls,CHI,Chicago,240.000000:00,108,43,24,19,11,2,3,7,4,5,9,1,1,2,2,2
0,0022000897,1610612747,Lakers,LAL,Los Angeles,240.000000:00,110,56,39,17,10,0,6,12,3,2,5,6,3,7,6,9
1,0022000897,1610612742,Mavericks,DAL,Dallas,240.000000:00,115,54,40,14,13,1,10,24,1,6,7,1,4,3,1,5
0,0022000898,1610612748,Heat,MIA,Miami,240.000000:00,103,45,22,23,15,1,12,27,4,1,5,1,10,9,0,11
1,0022000898,1610612737,Hawks,ATL,Atlanta,240.000000:00,118,49,26,23,14,0,9,24,5,4,9,1,13,12,3,14
0,0022000899,1610612738,Celtics,BOS,Boston,240.000000:00,104,55,38,17,8,0,9,23,6,3,9,2,2,4,3,4
1,0022000899,1610612751,Nets,BKN,Brooklyn,240.000000:00,109,50,26,24,17,2,7,16,4,3,7,1,5,6,5,6
0,0022000900,1610612739,Cavaliers,CLE,Cleveland,240.000000:00,102,58,37,21,10,1,7,16,3,6,9,2,14,14,6,16
1,0022000900,1610612766,Hornets,CHA,Charlotte,240.000000:00,108,45,23,22,16,1,7,18,2,2,4,5,6,7,6,11
0,0022000901,1610612746,Clippers,LAC,LA,240.000000:00,109,50,25,25,13,1,6,16,2,1,3,1,6,6,2,7
1,0022000901,1610612745,Rockets,HOU,Houston,240.000000:00,104,57,35,22,17,1,4,9,2,1,3,1,6,6,1,7
0,0022000902,1610612764,Wizards,WAS,Washington,240.000000:00,129,53,36,17,11,2,13,29,5,1,6,0,6,6,2,6
1,0022000902,1610612760,Thunder,OKC,Oklahoma City,240.000000:00,109,68,46,22,14,0,11,25,4,1,5,0,3,3,2,3
0,0022000903,1610612743,Nuggets,DEN,Denver,240.000000:00,97,30,14,16,16,0,5,13,6,3,9,0,4,4,1,4
1,0022000903,1610612744,Warriors,GSW,Golden State,240.000000:00,118,49,25,24,12,0,20,47,4,4,8,0,5,5,2,5
0,0022000904,1610612761,Raptors,TOR,Toronto,240.000000:00,103,49,28,21,16,1,9,21,1,4,5,1,23,16,4,24
1,0022000904,1610612752,Knicks,NYK,New York,240.000000:00,120,53,26,27,7,0,8,17,2,2,4,0,12,10,2,12
0,0022000905,1610612755,76ers,PHI,Philadelphia,240.000000:00,94,49,24,25,11,0,17,37,0,5,5,2,7,8,5,9
1,0022000905,1610612749,Bucks,MIL,Milwaukee,240.000000:00,132,53,31,22,17,0,7,16,1,3,4,4,3,4,3,7
0,0022000906,1610612765,Pistons,DET,Detroit,240.000000:00,109,57,35,22,13,0,8,17,4,1,5,2,8,10,2,10
1,0022000906,1610612754,Pacers,IND,Indiana,240.000000:00,115,42,29,13,15,0,11,23,1,2,3,2,6,8,3,8
0,0022000907,1610612741,Bulls,CHI,Chicago,240.000000:00,101,46,25,21,11,0,2,4,1,4,5,5,5,7,5,10
1,0022000907,1610612748,Heat,MIA,Miami,240.000000:00,106,45,20,25,15,1,14,34,3,4,7,2,6,6,5,8
0,0022000908,1610612747,Lakers,LAL,Los Angeles,240.000000:00,93,50,29,21,18,1,8,20,2,5,7,1,3,3,3,4
1,0022000908,1610612742,Mavericks,DAL,Dallas,240.000000:00,108,54,30,24,9,0,6,15,3,3,6,0,6,6,4,6
0,0022000909,1610612750,Timberwolves,MIN,Minnesota,240.000000:00,101,42,17,25,22,1,13,29,3,2,5,3,5,7,4,8
1,0022000909,1610612762,Jazz,UTA,Utah,240.000000:00,96,53,27,26,15,0,8,20,2,3,5,1,6,7,3,7
0,0022000910,1610612745,Rockets,HOU,Houston,240.000000:00,116,46,24,22,17,2,3,7,2,2,4,0,3,2,0,3
1,0022000910,1610612743,Nuggets,DEN,Denver,240.000000:00,129,46,24,22,17,0,9,22,2,6,8,0,6,6,2,6
0,0022000911,1610612738,Celtics,BOS,Boston,240.000000:00,104,45,18,27,11,1,3,8,5,3,8,1,6,7,2,7
1,0022000911,1610612766,Hornets,CHA,Charlotte,240.000000:00,125,53,29,24,14,2,6,13,1,3,4,2,15,8,5,17
0,0022000912,1610612756,Suns,PHX,Phoenix,240.000000:00,119,39,25,14,5,0,11,27,2,0,2,3,6,9,5,9
1,0022000912,1610612751,Nets,BKN,Brooklyn,240.000000:00,128,48,29,19,10,1,12,29,2,1,3,4,15,17,8,19
0,0022000913,1610612749,Bucks,MIL,Milwaukee,240.000000:00,104,67,44,23,11,0,7,14,4,4,8,1,13,10,6,14
1,0022000913,1610612737,Hawks,ATL,Atlanta,240.000000:00,111,51,33,18,7,0,16,38,0,1,1,2,5,7,4,7
0,0022000914,1610612754,Pacers,IND,Indiana,240.000000:00,131,49,31,18,15,0,7,14,2,3,5,1,10,6,3,11
1,0022000914,1610612753,Magic,ORL,Orlando,240.000000:00,112,40,24,16,16,0,3,6,2,3,5,0,6,4,3,6
0,0022000915,1610612758,Kings,SAC,Sacramento,240.000000:00,113,49,31,18,22,0,15,35,2,3,5,3,3,2,2,6
1,0022000915,1610612744,Warriors,GSW,Golden State,240.000000:00,117,40,20,20,13,1,9,22,4,3,7,2,6,7,1,8
0,0022000916,1610612737,Hawks,ATL,Atlanta,240.000000:00,86,50,34,16,17,0,9,21,2,3,5,3,9,9,7,12
1,0022000916,1610612765,Pistons,DET,Detroit,240.000000:00,100,53,36,17,11,0,9,19,5,8,13,3,7,9,7,10
0,0022000917,1610612747,Lakers,LAL,Los Angeles,240.000000:00,114,47,33,14,10,2,12,26,2,5,7,1,1,2,2,2
1,0022000917,1610612753,Magic,ORL,Orlando,240.000000:00,103,32,22,10,13,0,9,22,2,5,7,1,4,3,2,5
0,0022000918,1610612760,Thunder,OKC,Oklahoma City,240.000000:00,90,46,27,19,16,1,16,33,2,1,3,1,4,5,3,5
1,0022000918,1610612755,76ers,PHI,Philadelphia,240.000000:00,121,41,24,17,36,1,17,41,1,7,8,3,8,11,9,11
0,0022000919,1610612759,Spurs,SAS,San Antonio,265.000000:00,146,64,54,10,9,1,12,25,3,4,7,1,3,4,3,4
1,0022000919,1610612764,Wizards,WAS,Washington,265.000000:00,143,67,57,10,8,0,12,25,1,4,5,6,10,15,9,16
0,0022000920,1610612756,Suns,PHX,Phoenix,240.000000:00,118,58,37,21,14,0,12,26,3,1,4,2,9,10,2,11
1,0022000920,1610612752,Knicks,NYK,New York,240.000000:00,110,38,25,13,15,0,13,27,1,4,5,2,11,11,5,13
0,0022000921,1610612739,Cavaliers,CLE,Cleveland,240.000000:00,96,37,21,16,9,2,5,10,6,2,8,2,3,4,2,5
1,0022000921,1610612761,Raptors,TOR,Toronto,240.000000:00,112,39,21,18,22,1,6,14,2,5,7,1,12,12,6,13
0,0022000922,1610612741,Bulls,CHI,Chicago,240.000000:00,110,57,29,28,14,0,3,7,4,4,8,2,18,18,9,20
1,0022000922,1610612748,Heat,MIA,Miami,240.000000:00,102,45,28,17,20,2,8,18,0,4,4,2,14,12,1,16
0,0022000923,1610612762,Jazz,UTA,Utah,240.000000:00,104,34,19,15,14,0,7,17,4,2,6,1,9,7,2,10
1,0022000923,1610612750,Timberwolves,MIN,Minnesota,240.000000:00,105,37,14,23,14,0,5,11,2,4,6,0,12,7,3,12
0,0022000924,1610612746,Clippers,LAC,LA,240.000000:00,103,47,27,20,14,1,8,18,3,3,6,3,9,8,5,12
1,0022000924,1610612740,Pelicans,NOP,New Orleans,240.000000:00,120,62,33,29,17,0,10,23,3,3,6,1,6,7,5,7
0,0022000925,1610612763,Grizzlies,MEM,Memphis,240.000000:00,96,56,35,21,22,0,8,19,1,1,2,0,7,7,0,7
1,0022000925,1610612743,Nuggets,DEN,Denver,240.000000:00,120,41,22,19,20,0,10,20,3,2,5,2,5,5,2,7
0,0022000926,1610612742,Mavericks,DAL,Dallas,240.000000:00,106,44,29,15,18,0,11,25,5,2,7,2,5,5,2,7
1,0022000926,1610612758,Kings,SAC,Sacramento,240.000000:00,113,44,18,26,16,0,8,18,2,3,5,1,8,6,1,9
0,0022000927,1610612760,Thunder,OKC,Oklahoma City,240.000000:00,119,58,30,28,12,0,10,22,3,3,6,2,5,6,3,7
1,0022000927,1610612738,Celtics,BOS,Boston,240.000000:00,115,56,38,18,28,2,24,58,2,4,6,4,10,12,6,14
0,0022000928,1610612749,Bucks,MIL,Milwaukee,240.000000:00,114,55,26,29,20,1,7,16,4,6,10,2,8,8,3,10
1,0022000928,1610612766,Hornets,CHA,Charlotte,240.000000:00,104,50,30,20,15,2,5,14,2,3,5,0,8,7,1,8
0,0022000929,1610612757,Trail Blazers,POR,Portland,240.000000:00,133,50,30,20,9,1,15,38,2,3,5,6,5,8,7,11
1,0022000929,1610612754,Pacers,IND,Indiana,240.000000:00,112,74,52,22,13,0,10,20,3,3,6,0,2,2,2,2
0,0022000930,1610612751,Nets,BKN,Brooklyn,240.000000:00,116,55,30,25,16,1,5,10,2,4,6,1,15,15,5,16
1,0022000930,1610612761,Raptors,TOR,Toronto,240.000000:00,103,50,25,25,17,0,5,11,2,1,3,1,10,11,1,11
0,0022000931,1610612750,Timberwolves,MIN,Minnesota,240.000000:00,114,50,31,19,11,0,4,8,5,7,12,1,4,4,4,5
1,0022000931,1610612745,Rockets,HOU,Houston,240.000000:00,107,51,27,24,9,2,0,0,2,3,5,0,8,7,3,8
0,0022000932,1610612742,Mavericks,DAL,Dallas,240.000000:00,133,51,24,27,13,1,14,36,1,2,3,3,3,6,6,6
1,0022000932,1610612744,Warriors,GSW,Golden State,240.000000:00,103,62,37,25,14,0,11,28,1,7,8,0,6,5,2,6
0,0022000933,1610612753,Magic,ORL,Orlando,240.000000:00,109,49,23,26,11,0,11,22,3,6,9,0,5,3,0,5
1,0022000933,1610612739,Cavaliers,CLE,Cleveland,240.000000:00,104,40,28,12,14,0,11,27,5,3,8,1,3,3,1,4
0,0022000934,1610612737,Hawks,ATL,Atlanta,240.000000:00,83,42,25,17,17,1,5,10,3,1,4,1,2,3,0,3
1,0022000934,1610612755,76ers,PHI,Philadelphia,240.000000:00,127,44,36,8,30,0,16,36,2,1,3,1,4,5,1,5
0,0022000935,1610612747,Lakers,LAL,Los Angeles,240.000000:00,107,52,46,6,17,0,9,21,2,4,6,1,4,5,2,5
1,0022000935,1610612764,Wizards,WAS,Washington,240.000000:00,116,52,32,20,11,1,7,16,4,0,4,0,3,3,0,3
0,0022000936,1610612766,Hornets,CHA,Charlotte,240.000000:00,111,53,29,24,11,1,7,18,2,2,4,2,6,7,4,8
1,0022000936,1610612738,Celtics,BOS,Boston,240.000000:00,120,49,28,21,10,0,5,12,5,1,6,4,9,9,7,13
0,0022000937,1610612741,Bulls,CHI,Chicago,240.000000:00,94,58,42,16,9,1,5,10,4,3,7,1,4,5,4,5
1,0022000937,1610612752,Knicks,NYK,New York,240.000000:00,113,46,25,21,13,0,10,21,5,2,7,2,4,4,3,6
0,0022000938,1610612759,Spurs,SAS,San Antonio,240.000000:00,111,47,29,18,11,0,6,13,2,3,5,0,1,1,0,1
1,0022000938,1610612748,Heat,MIA,Miami,240.000000:00,116,49,33,16,9,1,8,18,5,1,6,2,4,6,2,6
0,0022000939,1610612757,Trail Blazers,POR,Portland,240.000000:00,130,51,32,19,14,0,14,33,0,3,3,3,4,7,5,7
1,0022000939,1610612763,Grizzlies,MEM,Memphis,240.000000:00,109,56,34,22,9,0,4,8,0,3,3,0,9,7,2,9
0,0022000940,1610612740,Pelicans,NOP,New Orleans,240.000000:00,112,59,34,25,14,0,7,16,1,1,2,1,2,3,2,3
1,0022000940,1610612743,Nuggets,DEN,Denver,240.000000:00,114,46,31,15,18,0,7,18,4,1,5,0,5,3,2,5
0,0022000941,1610612746,Clippers,LAC,LA,240.000000:00,101,51,28,23,13,0,7,15,4,5,9,1,10,9,5,11
1,0022000941,1610612756,Suns,PHX,Phoenix,240.000000:00,109,42,26,16,22,1,11,25,6,3,9,5,5,8,6,10
0,0022000942,1610612762,Jazz,UTA,Utah,240.000000:00,154,42,29,13,13,1,8,21,3,0,3,0,7,6,4,7
1,0022000942,1610612758,Kings,SAC,Sacramento,240.000000:00,105,45,21,24,15,1,16,36,1,0,1,0,7,1,1,7
0,0022000943,1610612742,Mavericks,DAL,Dallas,240.000000:00,115,40,24,16,12,0,20,48,3,3,6,0,14,4,0,14
1,0022000943,1610612765,Pistons,DET,Detroit,240.000000:00,105,62,43,19,12,0,5,12,1,3,4,2,11,8,2,13
0,0022000944,1610612751,Nets,BKN,Brooklyn,240.000000:00,130,55,31,24,8,1,3,6,4,5,9,3,12,14,4,15
1,0022000944,1610612754,Pacers,IND,Indiana,240.000000:00,113,54,32,22,16,0,2,5,3,3,6,2,10,11,0,12
0,0022000945,1610612749,Bucks,MIL,Milwaukee,240.000000:00,136,64,31,33,15,2,10,24,2,4,6,0,4,3,3,4
1,0022000945,1610612745,Rockets,HOU,Houston,240.000000:00,143,58,29,29,13,0,5,14,1,4,5,0,5,3,1,5
0,0022000946,1610612744,Warriors,GSW,Golden State,240.000000:00,114,50,29,21,18,1,9,25,3,3,6,0,5,5,2,5
1,0022000946,1610612750,Timberwolves,MIN,Minnesota,240.000000:00,126,49,30,19,9,0,9,22,1,1,2,0,1,1,0,1
0,0022000947,1610612740,Pelicans,NOP,New Orleans,240.000000:00,109,48,23,25,16,0,15,30,4,2,6,0,3,3,2,3
1,0022000947,1610612760,Thunder,OKC,Oklahoma City,240.000000:00,95,55,42,13,9,0,12,27,3,1,4,0,9,8,3,9
0,0022000948,1610612761,Raptors,TOR,Toronto,240.000000:00,111,58,33,25,17,0,6,15,0,4,4,2,3,2,1,5
1,0022000948,1610612743,Nuggets,DEN,Denver,240.000000:00,121,42,24,18,15,1,2,6,7,4,11,6,8,12,11,14
0,0022000949,1610612737,Hawks,ATL,Atlanta,240.000000:00,104,57,48,9,8,0,12,24,3,0,3,3,2,5,4,5
1,0022000949,1610612755,76ers,PHI,Philadelphia,240.000000:00,126,38,25,13,16,1,6,14,1,1,2,3,3,6,3,6
0,0022000950,1610612759,Spurs,SAS,San Antonio,265.000000:00,140,59,34,25,9,0,14,29,0,3,3,1,2,3,2,3
1,0022000950,1610612738,Celtics,BOS,Boston,265.000000:00,143,60,45,15,15,0,18,44,5,1,6,2,6,8,4,8
0,0022000951,1610612764,Wizards,WAS,Washington,240.000000:00,122,47,24,23,16,0,5,10,2,3,5,1,3,4,2,4
1,0022000951,1610612739,Cavaliers,CLE,Cleveland,240.000000:00,93,67,57,10,16,0,14,31,4,1,5,0,3,0,0,3
0,0022000952,1610612757,Trail Blazers,POR,Portland,240.000000:00,128,43,21,22,8,0,6,16,3,2,5,0,4,4,0,4
1,0022000952,1610612751,Nets,BKN,Brooklyn,240.000000:00,109,44,22,22,10,1,14,32,5,4,9,2,4,6,2,6
0,0022000953,1610612753,Magic,ORL,Orlando,240.000000:00,75,47,28,19,11,0,8,16,4,6,10,2,8,7,4,10
1,0022000953,1610612763,Grizzlies,MEM,Memphis,240.000000:00,92,60,42,18,25,0,7,17,2,3,5,0,9,9,5,9
0,0022000954,1610612749,Bucks,MIL,Milwaukee,240.000000:00,108,59,38,21,13,0,14,30,5,2,7,1,10,7,5,11
1,0022000954,1610612741,Bulls,CHI,Chicago,240.000000:00,98,60,43,17,8,0,13,30,3,1,4,2,5,7,5,7
0,0022000955,1610612762,Jazz,UTA,Utah,240.000000:00,100,52,34,18,10,0,7,17,2,3,5,1,10,7,3,11
1,0022000955,1610612756,Suns,PHX,Phoenix,240.000000:00,121,44,24,20,13,0,13,28,2,2,4,0,6,6,2,6
0,0022000956,1610612758,Kings,SAC,Sacramento,240.000000:00,110,39,26,13,19,1,7,16,2,4,6,0,6,4,3,6
1,0022000956,1610612747,Lakers,LAL,Los Angeles,240.000000:00,106,41,26,15,19,1,6,14,6,5,11,4,7,8,5,11
0,0022000957,1610612765,Pistons,DET,Detroit,240.000000:00,94,57,29,28,14,0,6,16,4,0,4,0,4,4,0,4
1,0022000957,1610612766,Hornets,CHA,Charlotte,240.000000:00,107,65,42,23,18,0,10,25,6,2,8,1,5,3,2,6
0,0022000958,1610612744,Warriors,GSW,Golden State,240.000000:00,113,59,30,29,18,2,13,35,8,1,9,0,11,10,3,11
1,0022000958,1610612745,Rockets,HOU,Houston,240.000000:00,87,45,21,24,13,0,4,9,7,3,10,2,6,6,2,8
0,0022000959,1610612741,Bulls,CHI,Chicago,240.000000:00,97,44,18,26,22,2,14,29,1,4,5,1,8,6,1,9
1,0022000959,1610612737,Hawks,ATL,Atlanta,240.000000:00,108,56,37,19,15,0,10,24,4,1,5,2,7,8,3,9
0,0022000960,1610612748,Heat,MIA,Miami,240.000000:00,124,39,19,20,15,0,9,21,2,5,7,1,6,7,4,7
1,0022000960,1610612739,Cavaliers,CLE,Cleveland,240.000000:00,107,52,32,20,6,0,9,23,2,1,3,2,0,2,2,2
0,0022000961,1610612763,Grizzlies,MEM,Memphis,240.000000:00,111,66,46,20,12,0,20,43,5,2,7,0,4,4,0,4
1,0022000961,1610612753,Magic,ORL,Orlando,240.000000:00,112,60,37,23,18,1,12,27,3,3,6,0,3,3,1,3
0,0022000962,1610612740,Pelicans,NOP,New Orleans,265.000000:00,140,67,37,30,15,0,8,18,1,1,2,0,2,2,1,2
1,0022000962,1610612750,Timberwolves,MIN,Minnesota,265.000000:00,136,63,40,23,19,0,10,24,3,6,9,0,6,4,3,6
0,0022000963,1610612754,Pacers,IND,Indiana,240.000000:00,152,64,44,20,13,0,15,35,1,3,4,0,1,1,0,1
1,0022000963,1610612760,Thunder,OKC,Oklahoma City,240.000000:00,95,54,30,24,15,1,5,13,2,2,4,1,1,2,1,2
0,0022000964,1610612764,Wizards,WAS,Washington,240.000000:00,124,42,23,19,19,1,15,32,3,4,7,2,9,10,4,11
1,0022000964,1610612742,Mavericks,DAL,Dallas,240.000000:00,125,58,47,11,15,0,28,64,2,1,3,1,11,9,4,12
0,0022000965,1610612761,Raptors,TOR,Toronto,240.000000:00,102,40,18,22,19,1,14,34,2,8,10,1,5,4,2,6
1,0022000965,1610612762,Jazz,UTA,Utah,240.000000:00,106,49,33,16,7,0,9,25,1,4,5,2,2,4,3,4
0,0022000966,1610612743,Nuggets,DEN,Denver,240.000000:00,110,44,27,17,15,0,3,7,2,1,3,2,3,3,3,5
1,0022000966,1610612746,Clippers,LAC,LA,240.000000:00,104,42,25,17,15,1,13,27,2,3,5,3,5,8,4,8
0,0022000967,1610612751,Nets,BKN,Brooklyn,240.000000:00,114,55,41,14,15,1,11,27,4,4,8,2,10,11,4,12
1,0022000967,1610612749,Bucks,MIL,Milwaukee,240.000000:00,117,68,40,28,17,0,5,11,6,2,8,2,8,6,4,10
0,0022000968,1610612757,Trail Blazers,POR,Portland,240.000000:00,129,50,29,21,15,0,13,32,2,2,4,3,2,5,4,5
1,0022000968,1610612738,Celtics,BOS,Boston,240.000000:00,119,49,28,21,8,1,7,18,4,2,6,2,6,7,4,8
0,0022000969,1610612748,Heat,MIA,Miami,240.000000:00,121,45,20,25,16,1,7,16,3,2,5,1,6,7,3,7
1,0022000969,1610612766,Hornets,CHA,Charlotte,240.000000:00,111,46,23,23,15,0,7,15,1,2,3,1,4,5,4,5
0,0022000970,1610612758,Kings,SAC,Sacramento,240.000000:00,111,44,22,22,12,0,11,24,3,2,5,1,6,7,4,7
1,0022000970,1610612742,Mavericks,DAL,Dallas,240.000000:00,99,47,32,15,13,0,14,29,0,6,6,4,2,6,5,6
0,0022000971,1610612752,Knicks,NYK,New York,240.000000:00,122,36,16,20,16,0,9,20,3,2,5,0,1,0,0,1
1,0022000971,1610612745,Rockets,HOU,Houston,240.000000:00,97,46,27,19,7,1,6,12,4,3,7,0,4,4,3,4
0,0022000972,1610612756,Suns,PHX,Phoenix,240.000000:00,123,56,32,24,22,0,15,32,1,2,3,0,3,3,1,3
1,0022000972,1610612760,Thunder,OKC,Oklahoma City,240.000000:00,120,60,37,23,8,0,13,30,3,0,3,0,6,5,1,6
0,0022000973,1610612755,76ers,PHI,Philadelphia,265.000000:00,113,45,30,15,11,3,11,24,2,1,3,4,3,7,7,7
1,0022000973,1610612759,Spurs,SAS,San Antonio,265.000000:00,111,48,30,18,12,1,17,42,3,3,6,1,5,6,2,6
0,0022000974,1610612761,Raptors,TOR,Toronto,240.000000:00,121,42,26,16,16,0,9,26,8,3,11,0,8,4,1,8
1,0022000974,1610612747,Lakers,LAL,Los Angeles,240.000000:00,114,45,30,15,14,0,4,9,2,2,4,5,5,8,4,10
0,0022000975,1610612753,Magic,ORL,Orlando,240.000000:00,119,47,26,21,16,0,9,20,2,1,3,1,11,12,5,12
1,0022000975,1610612765,Pistons,DET,Detroit,240.000000:00,112,56,39,17,17,1,12,25,2,5,7,1,5,6,3,6
0,0022000976,1610612754,Pacers,IND,Indiana,240.000000:00,141,47,35,12,14,0,18,40,2,1,3,2,5,6,5,7
1,0022000976,1610612764,Wizards,WAS,Washington,240.000000:00,154,70,55,15,12,0,6,14,2,3,5,1,7,6,2,8
0,0022000977,1610612744,Warriors,GSW,Golden State,240.000000:00,123,57,41,16,18,0,21,51,1,1,2,0,13,13,3,13
1,0022000977,1610612740,Pelicans,NOP,New Orleans,240.000000:00,108,42,17,25,8,2,8,16,2,3,5,4,2,6,4,6
0,0022000978,1610612757,Trail Blazers,POR,Portland,240.000000:00,114,58,28,30,11,0,12,29,2,2,4,0,4,2,1,4
1,0022000978,1610612737,Hawks,ATL,Atlanta,240.000000:00,123,59,30,29,10,0,9,21,0,4,4,2,9,9,5,11
0,0022000979,1610612755,76ers,PHI,Philadelphia,240.000000:00,106,29,18,11,15,0,5,12,7,2,9,1,5,6,4,6
1,0022000979,1610612741,Bulls,CHI,Chicago,240.000000:00,94,40,26,14,16,0,14,29,6,3,9,1,5,6,4,6
0,0022000980,1610612752,Knicks,NYK,New York,240.000000:00,118,49,24,25,8,0,21,46,2,2,4,0,3,3,1,3
1,0022000980,1610612763,Grizzlies,MEM,Memphis,240.000000:00,104,64,45,19,14,0,7,14,0,2,2,1,2,3,1,3
0,0022000981,1610612759,Spurs,SAS,San Antonio,240.000000:00,99,41,24,17,18,0,20,42,3,4,7,0,3,2,2,3
1,0022000981,1610612762,Jazz,UTA,Utah,240.000000:00,110,52,42,10,16,0,11,24,3,4,7,1,5,5,3,6
0,0022000982,1610612743,Nuggets,DEN,Denver,240.000000:00,89,45,28,17,23,1,5,11,2,1,3,0,8,7,5,8
1,0022000982,1610612747,Lakers,LAL,Los Angeles,240.000000:00,93,52,34,18,14,0,8,18,2,0,2,1,7,6,1,8
0,0022000983,1610612756,Suns,PHX,Phoenix,265.000000:00,134,59,43,16,20,0,16,35,0,3,3,2,6,8,6,8
1,0022000983,1610612739,Cavaliers,CLE,Cleveland,265.000000:00,118,69,50,19,6,0,16,38,1,1,2,3,5,8,5,8
0,0022000984,1610612766,Hornets,CHA,Charlotte,240.000000:00,102,60,35,25,15,0,11,23,3,2,5,3,9,10,7,12
1,0022000984,1610612765,Pistons,DET,Detroit,240.000000:00,99,64,41,23,13,0,6,14,2,2,4,4,7,10,7,11
0,0022000985,1610612751,Nets,BKN,Brooklyn,240.000000:00,118,54,33,21,17,1,12,34,1,2,3,1,22,15,3,23
1,0022000985,1610612749,Bucks,MIL,Milwaukee,240.000000:00,124,61,32,29,14,0,8,21,4,1,5,0,10,9,5,10
0,0022000986,1610612742,Mavericks,DAL,Dallas,240.000000:00,127,46,20,26,9,2,13,31,1,3,4,1,2,3,3,3
1,0022000986,1610612748,Heat,MIA,Miami,240.000000:00,113,55,21,34,13,1,14,37,2,2,4,0,10,10,5,10
0,0022000987,1610612744,Warriors,GSW,Golden State,240.000000:00,103,66,46,20,17,0,11,31,3,5,8,0,14,14,3,14
1,0022000987,1610612740,Pelicans,NOP,New Orleans,240.000000:00,108,57,26,31,18,0,11,26,6,5,11,0,6,6,2,6
0,0022000988,1610612758,Kings,SAC,Sacramento,240.000000:00,103,66,38,28,15,0,9,23,1,3,4,1,6,7,2,7
1,0022000988,1610612760,Thunder,OKC,Oklahoma City,240.000000:00,99,57,29,28,11,0,7,17,4,0,4,1,3,4,3,4
0,0022000989,1610612761,Raptors,TOR,Toronto,240.000000:00,100,39,18,21,15,0,9,21,3,3,6,3,5,8,4,8
1,0022000989,1610612746,Clippers,LAC,LA,240.000000:00,105,46,27,19,12,1,4,8,2,5,7,3,8,11,5,11
0,0022000990,1610612738,Celtics,BOS,Boston,240.000000:00,132,65,48,17,8,0,8,20,4,0,4,1,4,4,2,5
1,0022000990,1610612753,Magic,ORL,Orlando,240.000000:00,96,57,28,29,10,0,4,8,5,1,6,3,3,6,2,6
0,0022000991,1610612757,Trail Blazers,POR,Portland,240.000000:00,141,52,28,24,18,0,7,17,1,2,3,2,6,6,5,8
1,0022000991,1610612739,Cavaliers,CLE,Cleveland,240.000000:00,105,51,30,21,16,0,8,19,1,3,4,1,7,6,4,8
0,0022000992,1610612756,Suns,PHX,Phoenix,240.000000:00,103,45,29,16,18,0,9,20,0,3,3,0,7,7,0,7
1,0022000992,1610612737,Hawks,ATL,Atlanta,240.000000:00,135,47,27,20,12,0,11,24,2,3,5,2,4,5,2,6
0,0022000993,1610612758,Kings,SAC,Sacramento,240.000000:00,104,46,33,13,25,0,13,29,2,6,8,0,11,10,2,11
1,0022000993,1610612754,Pacers,IND,Indiana,240.000000:00,93,52,35,17,24,0,14,32,3,1,4,5,4,6,4,9
0,0022000994,1610612755,76ers,PHI,Philadelphia,240.000000:00,135,59,26,33,17,0,8,18,1,3,4,2,1,3,2,3
1,0022000994,1610612745,Rockets,HOU,Houston,240.000000:00,115,58,33,25,13,0,6,15,6,2,8,2,5,5,2,7
0,0022000995,1610612752,Knicks,NYK,New York,240.000000:00,97,72,41,31,17,0,5,10,0,3,3,1,4,2,2,5
1,0022000995,1610612743,Nuggets,DEN,Denver,240.000000:00,113,47,27,20,14,0,9,23,3,5,8,2,2,4,2,4
0,0022000996,1610612759,Spurs,SAS,San Antonio,240.000000:00,94,46,26,20,14,0,10,22,2,2,4,3,4,4,3,7
1,0022000996,1610612762,Jazz,UTA,Utah,240.000000:00,126,59,39,20,8,0,19,44,0,0,0,0,11,9,6,11
0,0022000997,1610612764,Wizards,WAS,Washington,265.000000:00,131,63,41,22,12,2,11,25,1,2,3,3,14,16,4,17
1,0022000997,1610612761,Raptors,TOR,Toronto,265.000000:00,129,57,43,14,20,0,11,27,4,5,9,0,15,8,0,15
0,0022000998,1610612751,Nets,BKN,Brooklyn,240.000000:00,109,61,34,27,8,0,10,24,0,0,0,1,9,10,4,10
1,0022000998,1610612742,Mavericks,DAL,Dallas,240.000000:00,113,60,35,25,11,1,12,33,3,2,5,2,6,8,5,8
0,0022000999,1610612763,Grizzlies,MEM,Memphis,240.000000:00,97,69,48,21,16,0,7,16,1,3,4,3,4,5,2,7
1,0022000999,1610612765,Pistons,DET,Detroit,240.000000:00,111,65,40,25,8,0,12,29,1,2,3,0,3,3,3,3
0,0022001000,1610612737,Hawks,ATL,Atlanta,240.000000:00,126,43,33,10,13,0,15,33,3,5,8,2,5,7,4,7
1,0022001000,1610612754,Pacers,IND,Indiana,240.000000:00,133,43,22,21,18,0,10,21,3,3,6,0,8,7,2,8
0,0022001001,1610612760,Thunder,OKC,Oklahoma City,240.000000:00,97,42,14,28,11,1,14,32,5,3,8,0,2,2,2,2
1,0022001001,1610612744,Warriors,GSW,Golden State,240.000000:00,118,48,31,17,11,2,17,42,2,2,4,1,12,12,5,13
0,0022001002,1610612747,Lakers,LAL,Los Angeles,240.000000:00,94,44,29,15,13,1,12,28,5,1,6,1,3,4,2,4
1,0022001002,1610612746,Clippers,LAC,LA,240.000000:00,118,48,30,18,13,0,8,19,1,1,2,2,3,5,3,5
0,0022001003,1610612740,Pelicans,NOP,New Orleans,240.000000:00,107,55,32,23,16,0,5,14,1,4,5,0,4,4,0,4
1,0022001003,1610612755,76ers,PHI,Philadelphia,240.000000:00,109,61,39,22,5,0,9,22,4,1,5,1,8,9,5,9
0,0022001004,1610612753,Magic,ORL,Orlando,240.000000:00,112,42,21,21,12,0,9,22,0,2,2,1,7,6,2,8
1,0022001004,1610612766,Hornets,CHA,Charlotte,240.000000:00,122,71,47,24,15,0,11,22,5,3,8,1,9,7,1,10
0,0022001005,1610612750,Timberwolves,MIN,Minnesota,240.000000:00,112,55,31,24,17,1,7,16,3,5,8,3,6,7,4,9
1,0022001005,1610612748,Heat,MIA,Miami,240.000000:00,121,39,19,20,11,2,6,14,3,4,7,0,13,7,2,13
0,0022001006,1610612745,Rockets,HOU,Houston,240.000000:00,133,59,30,29,15,2,9,23,2,4,6,0,5,5,0,5
1,0022001006,1610612749,Bucks,MIL,Milwaukee,240.000000:00,141,64,26,38,20,2,16,40,4,0,4,4,2,6,5,6
0,0022001007,1610612739,Cavaliers,CLE,Cleveland,240.000000:00,90,50,31,19,10,0,8,17,3,3,6,2,4,6,5,6
1,0022001007,1610612742,Mavericks,DAL,Dallas,240.000000:00,110,39,25,14,12,0,14,29,3,4,7,1,5,5,2,6
0,0022001008,1610612743,Nuggets,DEN,Denver,240.000000:00,120,32,14,18,16,0,18,46,0,3,3,3,3,5,4,6
1,0022001008,1610612762,Jazz,UTA,Utah,240.000000:00,127,39,22,17,12,0,9,24,4,4,8,2,4,4,2,6
0,0022001009,1610612752,Knicks,NYK,New York,240.000000:00,105,56,27,29,6,0,8,17,1,2,3,2,13,12,7,15
1,0022001009,1610612756,Suns,PHX,Phoenix,240.000000:00,128,54,34,20,8,1,8,17,2,0,2,3,4,6,5,7
0,0022001010,1610612747,Lakers,LAL,Los Angeles,240.000000:00,101,48,22,26,8,1,7,15,0,0,0,2,2,3,3,4
1,0022001010,1610612757,Trail Blazers,POR,Portland,240.000000:00,106,44,24,20,15,0,10,22,1,2,3,0,3,3,3,3
0,0022001011,1610612759,Spurs,SAS,San Antonio,240.000000:00,113,40,26,14,16,0,9,18,1,3,4,1,5,5,4,6
1,0022001011,1610612758,Kings,SAC,Sacramento,240.000000:00,104,52,38,14,19,0,12,28,3,3,6,1,10,8,2,11
0,0022001012,1610612764,Wizards,WAS,Washington,265.000000:00,133,50,36,14,6,2,10,22,4,3,7,0,3,3,2,3
1,0022001012,1610612754,Pacers,IND,Indiana,265.000000:00,132,51,39,12,15,0,16,37,3,1,4,2,4,5,2,6
0,0022001013,1610612765,Pistons,DET,Detroit,240.000000:00,104,39,26,13,10,1,9,20,2,3,5,0,6,5,3,6
1,0022001013,1610612755,76ers,PHI,Philadelphia,240.000000:00,118,32,17,15,14,1,7,16,3,4,7,0,11,11,8,11
0,0022001014,1610612763,Grizzlies,MEM,Memphis,240.000000:00,109,71,47,24,9,0,0,0,4,2,6,4,13,15,13,17
1,0022001014,1610612761,Raptors,TOR,Toronto,240.000000:00,99,52,21,31,7,1,12,28,3,5,8,0,11,9,9,11
0,0022001015,1610612751,Nets,BKN,Brooklyn,240.000000:00,125,61,34,27,19,0,5,11,1,4,5,0,15,13,4,15
1,0022001015,1610612743,Nuggets,DEN,Denver,240.000000:00,119,42,19,23,8,0,10,26,2,1,3,1,6,6,2,7
0,0022001016,1610612745,Rockets,HOU,Houston,240.000000:00,116,39,24,15,16,0,9,19,4,4,8,1,7,8,4,8
1,0022001016,1610612762,Jazz,UTA,Utah,240.000000:00,124,49,26,23,10,0,3,8,6,1,7,2,3,4,2,5
0,0022001017,1610612760,Thunder,OKC,Oklahoma City,240.000000:00,97,60,16,44,13,2,7,18,3,1,4,0,4,4,2,4
1,0022001017,1610612744,Warriors,GSW,Golden State,240.000000:00,136,63,42,21,11,3,16,44,1,1,2,2,4,5,5,6
0,0022001018,1610612759,Spurs,SAS,San Antonio,240.000000:00,102,51,32,19,12,0,15,30,0,1,1,0,9,6,2,9
1,0022001018,1610612757,Trail Blazers,POR,Portland,240.000000:00,124,46,32,14,13,0,14,33,5,3,8,2,10,12,5,12
0,0022001019,1610612752,Knicks,NYK,New York,240.000000:00,106,58,34,24,14,0,10,22,2,5,7,2,8,7,5,10
1,0022001019,1610612746,Clippers,LAC,LA,240.000000:00,100,55,36,19,9,0,7,17,3,3,6,2,9,8,5,11
0,0022001020,1610612740,Pelicans,NOP,New Orleans,240.000000:00,112,62,36,26,12,1,6,15,3,4,7,5,1,5,5,6
1,0022001020,1610612766,Hornets,CHA,Charlotte,240.000000:00,110,76,45,31,12,3,13,30,1,2,3,3,5,6,3,8
0,0022001021,1610612742,Mavericks,DAL,Dallas,240.000000:00,124,55,36,19,19,1,15,34,2,4,6,2,9,7,6,11
1,0022001021,1610612739,Cavaliers,CLE,Cleveland,240.000000:00,97,56,31,25,7,0,6,13,1,4,5,1,4,3,3,5
0,0022001022,1610612750,Timberwolves,MIN,Minnesota,240.000000:00,128,63,36,27,14,0,19,43,3,3,6,3,8,7,5,11
1,0022001022,1610612753,Magic,ORL,Orlando,240.000000:00,96,49,22,27,14,1,10,22,1,3,4,0,8,5,1,8
0,0022001023,1610612741,Bulls,CHI,Chicago,240.000000:00,108,51,33,18,18,1,9,21,1,1,2,0,7,7,2,7
1,0022001023,1610612765,Pistons,DET,Detroit,240.000000:00,96,50,29,21,11,0,10,21,2,2,4,1,3,4,1,4
0,0022001024,1610612756,Suns,PHX,Phoenix,240.000000:00,110,44,26,18,14,0,10,22,1,3,4,0,3,3,1,3
1,0022001024,1610612747,Lakers,LAL,Los Angeles,240.000000:00,123,39,24,15,16,0,5,12,3,6,9,1,1,2,1,2
0,0022001025,1610612760,Thunder,OKC,Oklahoma City,240.000000:00,98,50,27,23,16,0,4,9,2,0,2,0,0,0,0,0
1,0022001025,1610612758,Kings,SAC,Sacramento,240.000000:00,126,50,28,22,18,0,8,20,1,4,5,1,4,5,0,5
0,0022001026,1610612764,Wizards,WAS,Washington,240.000000:00,124,60,40,20,16,0,9,23,1,2,3,2,5,6,4,7
1,0022001026,1610612737,Hawks,ATL,Atlanta,240.000000:00,125,66,47,19,13,1,19,43,0,1,1,2,8,10,5,10
0,0022001027,1610612754,Pacers,IND,Indiana,240.000000:00,111,61,39,22,22,1,15,34,3,2,5,2,9,9,6,11
1,0022001027,1610612739,Cavaliers,CLE,Cleveland,240.000000:00,102,55,42,13,18,0,6,14,5,3,8,1,9,10,3,10
0,0022001028,1610612740,Pelicans,NOP,New Orleans,240.000000:00,110,47,34,13,16,0,12,26,3,2,5,0,4,3,1,4
1,0022001028,1610612763,Grizzlies,MEM,Memphis,240.000000:00,115,64,47,17,14,0,12,25,5,7,12,1,3,3,2,4
0,0022001029,1610612749,Bucks,MIL,Milwaukee,240.000000:00,125,58,45,13,13,1,11,28,1,2,3,0,8,5,2,8
1,0022001029,1610612759,Spurs,SAS,San Antonio,240.000000:00,146,50,27,23,14,1,23,57,3,1,4,2,5,5,3,7
0,0022001030,1610612762,Jazz,UTA,Utah,240.000000:00,116,51,25,26,11,0,9,22,3,5,8,4,3,7,6,7
1,0022001030,1610612744,Warriors,GSW,Golden State,240.000000:00,119,58,31,27,12,0,12,29,4,0,4,3,6,9,8,9
0,0022001031,1610612745,Rockets,HOU,Houston,240.000000:00,129,49,24,25,13,0,14,34,3,3,6,1,1,2,2,2
1,0022001031,1610612757,Trail Blazers,POR,Portland,240.000000:00,140,42,19,23,14,1,8,21,1,1,2,1,3,4,2,4
0,0022001032,1610612748,Heat,MIA,Miami,240.000000:00,129,60,35,25,19,1,17,44,3,2,5,1,10,11,1,11
1,0022001032,1610612738,Celtics,BOS,Boston,240.000000:00,121,46,31,15,17,2,8,20,2,1,3,0,2,2,0,2
0,0022001033,1610612750,Timberwolves,MIN,Minnesota,240.000000:00,119,41,32,9,23,0,9,20,3,7,10,2,4,6,3,6
1,0022001033,1610612765,Pistons,DET,Detroit,240.000000:00,100,53,29,24,16,0,12,28,3,3,6,3,7,8,4,10
0,0022001034,1610612746,Clippers,LAC,LA,240.000000:00,115,61,35,26,17,1,6,16,0,4,4,2,15,15,5,17
1,0022001034,1610612761,Raptors,TOR,Toronto,240.000000:00,96,41,21,20,19,0,12,28,1,4,5,1,11,10,3,12
0,0022001035,1610612755,76ers,PHI,Philadelphia,240.000000:00,94,56,26,30,18,0,7,16,2,2,4,0,5,4,0,5
1,0022001035,1610612754,Pacers,IND,Indiana,240.000000:00,103,49,32,17,11,0,16,41,1,4,5,1,1,2,2,2
0,0022001036,1610612751,Nets,BKN,Brooklyn,240.000000:00,115,71,37,34,12,1,12,28,3,2,5,0,6,5,3,6
1,0022001036,1610612741,Bulls,CHI,Chicago,240.000000:00,107,65,35,30,7,0,11,27,1,3,4,4,5,9,7,9
0,0022001037,1610612742,Mavericks,DAL,Dallas,240.000000:00,104,55,31,24,20,0,10,21,6,0,6,2,7,8,3,9
1,0022001037,1610612763,Grizzlies,MEM,Memphis,240.000000:00,133,56,29,27,27,0,17,39,3,5,8,3,20,21,9,23
0,0022001038,1610612753,Magic,ORL,Orlando,240.000000:00,102,52,31,21,14,0,16,36,2,1,3,4,3,7,5,7
1,0022001038,1610612749,Bucks,MIL,Milwaukee,240.000000:00,114,66,40,26,14,1,3,7,3,4,7,5,2,5,5,7
0,0022001039,1610612756,Suns,PHX,Phoenix,240.000000:00,116,37,20,17,13,1,7,18,5,3,8,0,8,6,3,8
1,0022001039,1610612744,Warriors,GSW,Golden State,240.000000:00,122,42,23,19,14,0,8,17,3,3,6,1,7,8,1,8
0,0022001040,1610612760,Thunder,OKC,Oklahoma City,240.000000:00,106,56,34,22,15,0,6,18,1,3,4,1,1,2,2,2
1,0022001040,1610612758,Kings,SAC,Sacramento,240.000000:00,122,49,34,15,16,1,12,30,0,3,3,0,3,3,1,3
0,0022001041,1610612752,Knicks,NYK,New York,265.000000:00,99,49,37,12,14,0,9,18,3,2,5,1,7,4,1,8
1,0022001041,1610612747,Lakers,LAL,Los Angeles,265.000000:00,101,55,38,17,11,0,5,11,8,3,11,4,8,12,4,12
0,0022001042,1610612764,Wizards,WAS,Washington,240.000000:00,116,32,16,16,16,0,8,19,1,2,3,1,9,8,5,10
1,0022001042,1610612737,Hawks,ATL,Atlanta,240.000000:00,120,63,47,16,10,0,18,40,3,2,5,0,8,8,3,8
0,0022001043,1610612759,Spurs,SAS,San Antonio,240.000000:00,116,44,25,19,13,0,8,17,2,3,5,4,8,11,7,12
1,0022001043,1610612751,Nets,BKN,Brooklyn,240.000000:00,128,64,44,20,10,0,6,13,3,2,5,1,12,9,6,13
0,0022001044,1610612738,Celtics,BOS,Boston,240.000000:00,94,49,35,14,16,0,12,30,4,4,8,0,6,4,3,6
1,0022001044,1610612739,Cavaliers,CLE,Cleveland,240.000000:00,102,61,38,23,12,1,10,22,0,1,1,0,6,4,4,6
0,0022001045,1610612757,Trail Blazers,POR,Portland,240.000000:00,105,55,32,23,12,0,16,36,3,3,6,3,2,5,3,5
1,0022001045,1610612762,Jazz,UTA,Utah,240.000000:00,98,64,39,25,10,1,12,29,2,2,4,0,7,7,5,7
0,0022001046,1610612745,Rockets,HOU,Houston,240.000000:00,122,44,33,11,10,1,5,11,2,2,4,1,1,2,2,2
1,0022001046,1610612747,Lakers,LAL,Los Angeles,240.000000:00,124,43,20,23,16,4,13,27,3,4,7,3,5,8,4,8
0,0022001047,1610612746,Clippers,LAC,LA,240.000000:00,113,58,32,26,11,0,5,14,3,4,7,3,11,12,2,14
1,0022001047,1610612766,Hornets,CHA,Charlotte,240.000000:00,90,47,19,28,20,0,6,14,2,0,2,2,16,18,6,18
0,0022001048,1610612749,Bucks,MIL,Milwaukee,240.000000:00,142,66,41,25,13,0,11,25,2,2,4,5,11,13,5,16
1,0022001048,1610612754,Pacers,IND,Indiana,240.000000:00,133,48,29,19,15,0,15,40,0,0,0,2,6,8,3,8
0,0022001049,1610612753,Magic,ORL,Orlando,240.000000:00,93,51,28,23,12,1,10,21,2,2,4,3,12,11,6,15
1,0022001049,1610612737,Hawks,ATL,Atlanta,240.000000:00,116,51,29,22,13,0,16,34,2,5,7,4,4,8,5,8
0,0022001050,1610612755,76ers,PHI,Philadelphia,240.000000:00,94,51,25,26,20,0,2,4,2,3,5,1,0,1,1,1
1,0022001050,1610612748,Heat,MIA,Miami,240.000000:00,106,53,35,18,14,2,10,23,4,4,8,2,2,1,1,4
0,0022001051,1610612761,Raptors,TOR,Toronto,240.000000:00,102,42,22,20,17,0,8,18,4,4,8,0,3,3,0,3
1,0022001051,1610612741,Bulls,CHI,Chicago,240.000000:00,114,38,26,12,9,0,7,18,3,2,5,1,13,13,8,14
0,0022001052,1610612743,Nuggets,DEN,Denver,240.000000:00,114,56,24,32,18,0,5,12,3,3,6,6,12,13,8,18
1,0022001052,1610612750,Timberwolves,MIN,Minnesota,240.000000:00,103,55,35,20,11,0,6,17,7,3,10,1,4,4,3,5
0,0022001053,1610612757,Trail Blazers,POR,Portland,240.000000:00,117,61,44,17,10,0,14,31,1,4,5,0,7,6,4,7
1,0022001053,1610612756,Suns,PHX,Phoenix,240.000000:00,118,61,42,19,11,1,19,40,5,1,6,2,4,6,3,6
0,0022001054,1610612743,Nuggets,DEN,Denver,240.000000:00,104,37,20,17,15,0,9,20,2,1,3,1,4,3,3,5
1,0022001054,1610612765,Pistons,DET,Detroit,240.000000:00,91,55,34,21,11,0,3,8,4,0,4,2,4,5,2,6
0,0022001055,1610612753,Magic,ORL,Orlando,240.000000:00,97,50,31,19,8,1,8,19,5,2,7,2,1,3,3,3
1,0022001055,1610612755,76ers,PHI,Philadelphia,240.000000:00,122,52,31,21,20,1,18,43,1,1,2,0,0,0,0,0
0,0022001056,1610612762,Jazz,UTA,Utah,240.000000:00,109,43,31,12,13,0,13,33,3,2,5,2,3,4,3,5
1,0022001056,1610612760,Thunder,OKC,Oklahoma City,240.000000:00,93,42,27,15,12,0,7,15,4,0,4,0,3,3,2,3
0,0022001057,1610612761,Raptors,TOR,Toronto,240.000000:00,110,41,20,21,11,0,8,20,6,0,6,0,5,4,2,5
1,0022001057,1610612742,Mavericks,DAL,Dallas,240.000000:00,114,41,21,20,8,1,6,14,2,1,3,2,10,9,6,12
0,0022001058,1610612746,Clippers,LAC,LA,240.000000:00,115,38,14,24,12,2,12,27,2,2,4,0,3,3,1,3
1,0022001058,1610612745,Rockets,HOU,Houston,240.000000:00,122,44,25,19,8,0,11,28,6,2,8,0,5,5,2,5
0,0022001059,1610612740,Pelicans,NOP,New Orleans,240.000000:00,122,52,31,21,14,0,10,20,1,2,3,1,3,3,2,4
1,0022001059,1610612744,Warriors,GSW,Golden State,240.000000:00,125,61,43,18,10,0,16,40,2,2,4,1,15,10,3,16
0,0022001060,1610612741,Bulls,CHI,Chicago,240.000000:00,91,64,36,28,11,0,4,12,5,0,5,4,5,9,7,9
1,0022001060,1610612751,Nets,BKN,Brooklyn,240.000000:00,105,59,34,25,9,0,7,18,0,4,4,0,6,5,2,6
0,0022001061,1610612747,Lakers,LAL,Los Angeles,240.000000:00,122,61,36,25,12,1,5,11,2,1,3,2,3,5,5,5
1,0022001061,1610612754,Pacers,IND,Indiana,240.000000:00,115,63,41,22,17,0,5,10,2,3,5,2,3,4,3,5
0,0022001062,1610612748,Heat,MIA,Miami,240.000000:00,108,38,23,15,15,0,17,46,2,5,7,2,6,7,2,8
1,0022001062,1610612749,Bucks,MIL,Milwaukee,240.000000:00,122,55,25,30,11,0,8,20,2,4,6,0,7,6,0,7
0,0022001063,1610612738,Celtics,BOS,Boston,240.000000:00,124,71,44,27,11,0,8,23,0,4,4,1,7,7,3,8
1,0022001063,1610612750,Timberwolves,MIN,Minnesota,240.000000:00,108,64,32,32,14,0,4,10,4,1,5,4,4,6,4,8
0,0022001064,1610612766,Hornets,CHA,Charlotte,265.000000:00,109,59,36,23,12,0,7,16,4,1,5,3,16,18,9,19
1,0022001064,1610612752,Knicks,NYK,New York,265.000000:00,118,59,31,28,12,0,7,17,2,1,3,1,12,11,3,13
0,0022001065,1610612756,Suns,PHX,Phoenix,240.000000:00,140,46,29,17,15,2,12,27,2,4,6,0,1,1,0,1
1,0022001065,1610612759,Spurs,SAS,San Antonio,240.000000:00,103,45,26,19,11,0,11,22,4,2,6,0,1,1,0,1
0,0022001066,1610612745,Rockets,HOU,Houston,240.000000:00,95,43,33,10,12,0,5,15,3,7,10,1,9,6,3,10
1,0022001066,1610612737,Hawks,ATL,Atlanta,240.000000:00,124,59,22,37,14,0,13,27,4,5,9,1,7,5,4,8
0,0022001067,1610612739,Cavaliers,CLE,Cleveland,240.000000:00,109,50,32,18,8,0,5,12,3,2,5,1,4,5,3,5
1,0022001067,1610612751,Nets,BKN,Brooklyn,240.000000:00,123,51,23,28,12,0,8,19,4,1,5,0,2,2,0,2
0,0022001068,1610612749,Bucks,MIL,Milwaukee,240.000000:00,112,62,40,22,17,0,9,20,3,3,6,1,5,5,2,6
1,0022001068,1610612741,Bulls,CHI,Chicago,240.000000:00,118,65,39,26,12,0,7,16,3,3,6,3,1,3,3,4
0,0022001069,1610612748,Heat,MIA,Miami,240.000000:00,120,57,33,24,21,3,15,36,1,1,2,3,7,7,4,10
1,0022001069,1610612765,Pistons,DET,Detroit,240.000000:00,107,43,21,22,18,2,8,18,4,0,4,3,3,6,6,6
0,0022001070,1610612763,Grizzlies,MEM,Memphis,240.000000:00,101,53,24,29,17,0,7,15,2,3,5,2,8,10,4,10
1,0022001070,1610612744,Warriors,GSW,Golden State,240.000000:00,113,65,44,21,10,1,9,23,5,2,7,0,9,9,3,9
0,0022001071,1610612742,Mavericks,DAL,Dallas,240.000000:00,121,51,22,29,11,1,11,25,0,2,2,2,5,5,4,7
1,0022001071,1610612750,Timberwolves,MIN,Minnesota,240.000000:00,136,59,30,29,20,0,6,15,4,3,7,1,6,6,4,7
0,0022001072,1610612747,Lakers,LAL,Los Angeles,240.000000:00,110,31,20,11,23,1,11,24,2,2,4,1,4,4,2,5
1,0022001072,1610612740,Pelicans,NOP,New Orleans,240.000000:00,98,31,21,10,9,0,4,10,5,0,5,0,2,1,0,2
0,0022001073,1610612738,Celtics,BOS,Boston,240.000000:00,92,51,36,15,11,0,8,21,3,2,5,4,11,12,6,15
1,0022001073,1610612752,Knicks,NYK,New York,240.000000:00,96,52,31,21,14,0,11,28,3,3,6,1,21,17,3,22
0,0022001074,1610612746,Clippers,LAC,LA,240.000000:00,112,47,35,12,14,2,18,39,3,5,8,2,3,5,3,5
1,0022001074,1610612760,Thunder,OKC,Oklahoma City,240.000000:00,117,60,37,23,8,0,18,44,3,2,5,1,1,2,1,2
0,0022001075,1610612753,Magic,ORL,Orlando,240.000000:00,117,46,20,26,11,0,11,24,4,3,7,0,9,7,2,9
1,0022001075,1610612755,76ers,PHI,Philadelphia,240.000000:00,128,49,29,20,18,2,9,22,3,4,7,1,9,6,3,10
0,0022001076,1610612743,Nuggets,DEN,Denver,240.000000:00,116,32,14,18,12,1,11,24,4,2,6,1,3,3,3,4
1,0022001076,1610612757,Trail Blazers,POR,Portland,240.000000:00,132,52,32,20,7,0,11,30,2,2,4,6,3,8,8,9
0,0022001077,1610612762,Jazz,UTA,Utah,240.000000:00,121,45,27,18,10,0,9,24,1,3,4,4,4,6,4,8
1,0022001077,1610612758,Kings,SAC,Sacramento,240.000000:00,99,50,26,24,16,0,9,22,2,2,4,1,2,3,2,3
0,0022001078,1610612756,Suns,PHX,Phoenix,240.000000:00,123,70,51,19,13,0,21,45,3,3,6,0,8,7,4,8
1,0022001078,1610612759,Spurs,SAS,San Antonio,240.000000:00,121,66,46,20,14,0,7,15,1,2,3,0,11,11,6,11
0,0022001079,1610612754,Pacers,IND,Indiana,240.000000:00,125,55,33,22,12,0,10,23,1,1,2,0,7,6,2,7
1,0022001079,1610612761,Raptors,TOR,Toronto,240.000000:00,113,52,30,22,15,1,11,27,4,2,6,1,4,5,3,5
0,0022001080,1610612766,Hornets,CHA,Charlotte,240.000000:00,110,58,36,22,21,1,7,15,6,2,8,1,6,5,3,7
1,0022001080,1610612764,Wizards,WAS,Washington,240.000000:00,115,60,31,29,9,1,5,11,1,3,4,3,10,11,8,13
